team_id,team_name,season,level_id,level_name,month,games,sb,cs,attempts,sb_allowed,cs_allowed,attempts_allowed,success_rate,success_rate_allowed
102,Round Rock Express,2021,11,AAA,5,26,35,12,47,15,5,20,0.7446808510638298,0.75
102,Round Rock Express,2021,11,AAA,6,28,31,12,43,19,8,27,0.7209302325581395,0.7037037037037037
102,Round Rock Express,2021,11,AAA,7,30,22,11,33,19,11,30,0.6666666666666666,0.6333333333333333
102,Round Rock Express,2021,11,AAA,8,30,7,8,15,30,6,36,0.4666666666666667,0.8333333333333334
102,Round Rock Express,2021,11,AAA,9,25,7,3,10,28,8,36,0.7,0.7777777777777778
102,Round Rock Express,2021,11,AAA,10,3,0,1,1,1,1,2,0.0,0.5
105,Sacramento River Cats,2021,11,AAA,5,23,17,4,21,10,3,13,0.8095238095238095,0.7692307692307693
105,Sacramento River Cats,2021,11,AAA,6,26,9,6,15,19,6,25,0.6,0.76
105,Sacramento River Cats,2021,11,AAA,7,29,21,5,26,22,5,27,0.8076923076923077,0.8148148148148148
105,Sacramento River Cats,2021,11,AAA,8,27,30,3,33,10,10,20,0.9090909090909091,0.5
105,Sacramento River Cats,2021,11,AAA,9,28,9,6,15,9,4,13,0.6,0.6923076923076923
105,Sacramento River Cats,2021,11,AAA,10,3,3,1,4,1,0,1,0.75,1.0
106,Erie SeaWolves,2021,12,AA,5,27,16,9,25,6,7,13,0.64,0.46153846153846156
106,Erie SeaWolves,2021,12,AA,6,32,32,6,38,19,7,26,0.8421052631578947,0.7307692307692307
106,Erie SeaWolves,2021,12,AA,7,39,19,10,29,15,13,28,0.6551724137931034,0.5357142857142857
106,Erie SeaWolves,2021,12,AA,8,4,1,1,2,1,1,2,0.5,0.5
233,Charleston RiverDogs,2019,14,A,4,4,3,3,6,4,0,4,0.5,1.0
233,Charleston RiverDogs,2019,14,A,5,30,27,15,42,23,8,31,0.6428571428571429,0.7419354838709677
233,Charleston RiverDogs,2019,14,A,6,29,19,11,30,36,14,50,0.6333333333333333,0.72
233,Charleston RiverDogs,2019,14,A,7,34,46,20,66,29,11,40,0.696969696969697,0.725
233,Charleston RiverDogs,2019,14,A,8,29,32,14,46,25,13,38,0.6956521739130435,0.6578947368421053
233,Charleston RiverDogs,2019,14,A,9,2,2,1,3,1,0,1,0.6666666666666666,1.0
234,Durham Bulls,2021,11,AAA,5,27,20,8,28,26,9,35,0.7142857142857143,0.7428571428571429
234,Durham Bulls,2021,11,AAA,6,27,23,5,28,16,7,23,0.8214285714285714,0.6956521739130435
234,Durham Bulls,2021,11,AAA,7,30,32,11,43,17,5,22,0.7441860465116279,0.7727272727272727
234,Durham Bulls,2021,11,AAA,8,29,42,11,53,19,11,30,0.7924528301886793,0.6333333333333333
234,Durham Bulls,2021,11,AAA,9,29,31,8,39,13,6,19,0.7948717948717948,0.6842105263157895
234,Durham Bulls,2021,11,AAA,10,3,0,2,2,0,2,2,0.0,0.0
235,Memphis Redbirds,2021,11,AAA,5,24,12,6,18,14,6,20,0.6666666666666666,0.7
235,Memphis Redbirds,2021,11,AAA,6,35,14,6,20,39,8,47,0.7,0.8297872340425532
235,Memphis Redbirds,2021,11,AAA,7,36,16,8,24,15,7,22,0.6666666666666666,0.6818181818181818
235,Memphis Redbirds,2021,11,AAA,8,30,8,10,18,22,6,28,0.4444444444444444,0.7857142857142857
235,Memphis Redbirds,2021,11,AAA,9,29,18,10,28,19,11,30,0.6428571428571429,0.6333333333333333
235,Memphis Redbirds,2021,11,AAA,10,3,1,0,1,0,1,1,1.0,0.0
237,Midland RockHounds,2021,12,AA,5,24,17,5,22,18,11,29,0.7727272727272727,0.6206896551724138
237,Midland RockHounds,2021,12,AA,6,29,17,6,23,32,20,52,0.7391304347826086,0.6153846153846154
237,Midland RockHounds,2021,12,AA,7,30,16,6,22,18,7,25,0.7272727272727273,0.72
237,Midland RockHounds,2021,12,AA,8,3,5,1,6,1,1,2,0.8333333333333334,0.5
238,Oklahoma City Dodgers,2021,11,AAA,5,23,8,2,10,30,6,36,0.8,0.8333333333333334
238,Oklahoma City Dodgers,2021,11,AAA,6,28,16,3,19,15,6,21,0.8421052631578947,0.7142857142857143
238,Oklahoma City Dodgers,2021,11,AAA,7,30,13,6,19,15,7,22,0.6842105263157895,0.6818181818181818
238,Oklahoma City Dodgers,2021,11,AAA,8,27,10,7,17,11,6,17,0.5882352941176471,0.6470588235294118
238,Oklahoma City Dodgers,2021,11,AAA,9,25,10,3,13,13,2,15,0.7692307692307693,0.8666666666666667
238,Oklahoma City Dodgers,2021,11,AAA,10,3,5,1,6,3,0,3,0.8333333333333334,1.0
247,Birmingham Barons,2021,12,AA,5,27,33,6,39,17,14,31,0.8461538461538461,0.5483870967741935
247,Birmingham Barons,2021,12,AA,6,30,33,5,38,11,10,21,0.868421052631579,0.5238095238095238
247,Birmingham Barons,2021,12,AA,7,41,51,12,63,21,21,42,0.8095238095238095,0.5
247,Birmingham Barons,2021,12,AA,8,3,7,3,10,2,0,2,0.7,1.0
260,Tulsa Drillers,2021,12,AA,5,24,14,7,21,22,9,31,0.6666666666666666,0.7096774193548387
260,Tulsa Drillers,2021,12,AA,6,27,23,12,35,29,15,44,0.6571428571428571,0.6590909090909091
260,Tulsa Drillers,2021,12,AA,7,32,18,1,19,29,4,33,0.9473684210526315,0.8787878787878788
260,Tulsa Drillers,2021,12,AA,8,3,0,0,0,0,0,0,,
342,Albuquerque Isotopes,2021,11,AAA,5,23,18,1,19,18,10,28,0.9473684210526315,0.6428571428571429
342,Albuquerque Isotopes,2021,11,AAA,6,25,9,6,15,14,10,24,0.6,0.5833333333333334
342,Albuquerque Isotopes,2021,11,AAA,7,33,21,5,26,34,9,43,0.8076923076923077,0.7906976744186046
342,Albuquerque Isotopes,2021,11,AAA,8,31,14,7,21,19,9,28,0.6666666666666666,0.6785714285714286
342,Albuquerque Isotopes,2021,11,AAA,9,27,11,4,15,20,11,31,0.7333333333333333,0.6451612903225806
342,Albuquerque Isotopes,2021,11,AAA,10,3,1,0,1,3,1,4,1.0,0.75
400,Las Vegas Aviators,2021,11,AAA,5,23,15,2,17,11,5,16,0.8823529411764706,0.6875
400,Las Vegas Aviators,2021,11,AAA,6,25,2,4,6,9,4,13,0.3333333333333333,0.6923076923076923
400,Las Vegas Aviators,2021,11,AAA,7,30,5,0,5,19,6,25,1.0,0.76
400,Las Vegas Aviators,2021,11,AAA,8,27,11,4,15,14,4,18,0.7333333333333333,0.7777777777777778
400,Las Vegas Aviators,2021,11,AAA,9,25,20,1,21,12,6,18,0.9523809523809523,0.6666666666666666
400,Las Vegas Aviators,2021,11,AAA,10,3,0,0,0,0,0,0,,
402,Akron RubberDucks,2021,12,AA,5,33,19,19,38,13,7,20,0.5,0.65
402,Akron RubberDucks,2021,12,AA,6,35,34,6,40,26,12,38,0.85,0.6842105263157895
402,Akron RubberDucks,2021,12,AA,7,34,35,15,50,10,10,20,0.7,0.5
402,Akron RubberDucks,2021,12,AA,8,4,3,1,4,1,1,2,0.75,0.5
404,AZL Angels,2019,16,Rookie,6,11,4,1,5,21,9,30,0.8,0.7
404,AZL Angels,2019,16,Rookie,7,20,15,9,24,48,12,60,0.625,0.8
404,AZL Angels,2019,16,Rookie,8,21,22,14,36,41,19,60,0.6111111111111112,0.6833333333333333
405,AZL Athletics Green,2019,16,Rookie,6,11,16,4,20,23,7,30,0.8,0.7666666666666667
405,AZL Athletics Green,2019,16,Rookie,7,21,15,16,31,24,16,40,0.4838709677419355,0.6
405,AZL Athletics Green,2019,16,Rookie,8,23,25,11,36,42,13,55,0.6944444444444444,0.7636363636363637
406,AZL Brewers Gold,2019,16,Rookie,6,11,17,8,25,11,4,15,0.68,0.7333333333333333
406,AZL Brewers Gold,2019,16,Rookie,7,21,23,11,34,29,11,40,0.6764705882352942,0.725
406,AZL Brewers Gold,2019,16,Rookie,8,21,29,8,37,24,18,42,0.7837837837837838,0.5714285714285714
407,AZL Cubs 1,2019,16,Rookie,6,11,21,6,27,7,7,14,0.7777777777777778,0.5
407,AZL Cubs 1,2019,16,Rookie,7,20,35,14,49,36,7,43,0.7142857142857143,0.8372093023255814
407,AZL Cubs 1,2019,16,Rookie,8,21,30,18,48,42,9,51,0.625,0.8235294117647058
408,AZL Giants Black,2019,16,Rookie,6,11,10,6,16,19,7,26,0.625,0.7307692307692307
408,AZL Giants Black,2019,16,Rookie,7,22,29,17,46,46,9,55,0.6304347826086957,0.8363636363636363
408,AZL Giants Black,2019,16,Rookie,8,23,24,16,40,42,4,46,0.6,0.9130434782608695
409,AZL Mariners,2019,16,Rookie,6,11,9,2,11,7,6,13,0.8181818181818182,0.5384615384615384
409,AZL Mariners,2019,16,Rookie,7,21,27,11,38,34,5,39,0.7105263157894737,0.8717948717948718
409,AZL Mariners,2019,16,Rookie,8,21,18,6,24,30,9,39,0.75,0.7692307692307693
410,AZL Padres 1,2019,16,Rookie,6,11,18,7,25,12,5,17,0.72,0.7058823529411765
410,AZL Padres 1,2019,16,Rookie,7,21,32,7,39,18,17,35,0.8205128205128205,0.5142857142857142
410,AZL Padres 1,2019,16,Rookie,8,21,16,7,23,26,12,38,0.6956521739130435,0.6842105263157895
411,AZL Rangers,2019,16,Rookie,6,12,14,5,19,14,2,16,0.7368421052631579,0.875
411,AZL Rangers,2019,16,Rookie,7,21,30,11,41,35,7,42,0.7317073170731707,0.8333333333333334
411,AZL Rangers,2019,16,Rookie,8,20,36,9,45,25,7,32,0.8,0.78125
412,AZL Royals,2019,16,Rookie,6,11,5,7,12,10,3,13,0.4166666666666667,0.7692307692307693
412,AZL Royals,2019,16,Rookie,7,22,33,6,39,29,14,43,0.8461538461538461,0.6744186046511628
412,AZL Royals,2019,16,Rookie,8,26,48,15,63,39,6,45,0.7619047619047619,0.8666666666666667
416,Louisville Bats,2021,11,AAA,5,24,14,3,17,13,6,19,0.8235294117647058,0.6842105263157895
416,Louisville Bats,2021,11,AAA,6,34,16,6,22,12,6,18,0.7272727272727273,0.6666666666666666
416,Louisville Bats,2021,11,AAA,7,36,25,12,37,18,6,24,0.6756756756756757,0.75
416,Louisville Bats,2021,11,AAA,8,27,9,6,15,14,6,20,0.6,0.7
416,Louisville Bats,2021,11,AAA,9,29,6,5,11,11,4,15,0.5454545454545454,0.7333333333333333
416,Louisville Bats,2021,11,AAA,10,3,1,0,1,0,1,1,1.0,0.0
418,Bowie Baysox,2021,12,AA,5,34,16,11,27,14,6,20,0.5925925925925926,0.7
418,Bowie Baysox,2021,12,AA,6,26,20,7,27,17,10,27,0.7407407407407407,0.6296296296296297
418,Bowie Baysox,2021,12,AA,7,36,12,11,23,17,8,25,0.5217391304347826,0.68
418,Bowie Baysox,2021,12,AA,8,4,2,2,4,5,1,6,0.5,0.8333333333333334
420,Burlington Bees,2019,14,A,4,7,1,2,3,6,2,8,0.3333333333333333,0.75
420,Burlington Bees,2019,14,A,5,50,34,7,41,70,18,88,0.8292682926829268,0.7954545454545454
420,Burlington Bees,2019,14,A,6,30,22,8,30,38,10,48,0.7333333333333333,0.7916666666666666
420,Burlington Bees,2019,14,A,7,28,19,17,36,17,17,34,0.5277777777777778,0.5
420,Burlington Bees,2019,14,A,8,30,28,8,36,43,9,52,0.7777777777777778,0.8269230769230769
420,Burlington Bees,2019,14,A,9,2,0,1,1,1,1,2,0.0,0.5
421,Montgomery Biscuits,2021,12,AA,5,25,21,14,35,22,5,27,0.6,0.8148148148148148
421,Montgomery Biscuits,2021,12,AA,6,37,35,19,54,27,12,39,0.6481481481481481,0.6923076923076923
421,Montgomery Biscuits,2021,12,AA,7,38,23,17,40,23,8,31,0.575,0.7419354838709677
421,Montgomery Biscuits,2021,12,AA,8,7,13,3,16,2,1,3,0.8125,0.6666666666666666
422,Buffalo Bisons,2021,11,AAA,5,29,32,18,50,21,4,25,0.64,0.84
422,Buffalo Bisons,2021,11,AAA,6,35,28,9,37,28,9,37,0.7567567567567568,0.7567567567567568
422,Buffalo Bisons,2021,11,AAA,7,45,15,6,21,17,6,23,0.7142857142857143,0.7391304347826086
422,Buffalo Bisons,2021,11,AAA,8,36,25,9,34,25,5,30,0.7352941176470589,0.8333333333333334
422,Buffalo Bisons,2021,11,AAA,9,28,35,6,41,18,2,20,0.8536585365853658,0.9
422,Buffalo Bisons,2021,11,AAA,10,3,0,1,1,0,0,0,0.0,
427,Lakewood BlueClaws,2019,14,A,4,4,1,4,5,6,3,9,0.2,0.6666666666666666
427,Lakewood BlueClaws,2019,14,A,5,36,40,10,50,29,13,42,0.8,0.6904761904761905
427,Lakewood BlueClaws,2019,14,A,6,32,36,25,61,20,18,38,0.5901639344262295,0.5263157894736842
427,Lakewood BlueClaws,2019,14,A,7,31,35,11,46,30,10,40,0.7608695652173914,0.75
427,Lakewood BlueClaws,2019,14,A,8,29,26,15,41,16,6,22,0.6341463414634146,0.7272727272727273
427,Lakewood BlueClaws,2019,14,A,9,2,1,0,1,2,3,5,1.0,0.4
428,Greenville Drive,2019,14,A,4,4,2,2,4,3,1,4,0.5,0.75
428,Greenville Drive,2019,14,A,5,32,37,17,54,25,8,33,0.6851851851851852,0.7575757575757576
428,Greenville Drive,2019,14,A,6,30,26,9,35,34,6,40,0.7428571428571429,0.85
428,Greenville Drive,2019,14,A,7,28,10,9,19,28,9,37,0.5263157894736842,0.7567567567567568
428,Greenville Drive,2019,14,A,8,32,11,7,18,32,9,41,0.6111111111111112,0.7804878048780488
428,Greenville Drive,2019,14,A,9,2,1,0,1,2,1,3,1.0,0.6666666666666666
430,Mississippi Braves,2021,12,AA,5,33,22,12,34,18,13,31,0.6470588235294118,0.5806451612903226
430,Mississippi Braves,2021,12,AA,6,26,18,7,25,14,13,27,0.72,0.5185185185185185
430,Mississippi Braves,2021,12,AA,7,33,22,3,25,12,4,16,0.88,0.75
430,Mississippi Braves,2021,12,AA,8,3,1,1,2,4,3,7,0.5,0.5714285714285714
431,Gwinnett Stripers,2021,11,AAA,5,24,24,9,33,12,5,17,0.7272727272727273,0.7058823529411765
431,Gwinnett Stripers,2021,11,AAA,6,33,38,8,46,19,3,22,0.8260869565217391,0.8636363636363636
431,Gwinnett Stripers,2021,11,AAA,7,32,23,7,30,21,4,25,0.7666666666666667,0.84
431,Gwinnett Stripers,2021,11,AAA,8,33,17,6,23,20,9,29,0.7391304347826086,0.6896551724137931
431,Gwinnett Stripers,2021,11,AAA,9,32,21,13,34,21,10,31,0.6176470588235294,0.6774193548387096
431,Gwinnett Stripers,2021,11,AAA,10,3,0,2,2,2,1,3,0.0,0.6666666666666666
432,Rome Braves,2019,14,A,4,4,3,1,4,6,4,10,0.75,0.6
432,Rome Braves,2019,14,A,5,34,21,10,31,10,13,23,0.6774193548387096,0.43478260869565216
432,Rome Braves,2019,14,A,6,27,26,6,32,22,7,29,0.8125,0.7586206896551724
432,Rome Braves,2019,14,A,7,28,27,11,38,17,10,27,0.7105263157894737,0.6296296296296297
432,Rome Braves,2019,14,A,8,32,35,5,40,17,14,31,0.875,0.5483870967741935
432,Rome Braves,2019,14,A,9,2,4,0,4,2,4,6,1.0,0.3333333333333333
437,Lake County Captains,2019,14,A,4,4,3,1,4,3,2,5,0.75,0.6
437,Lake County Captains,2019,14,A,5,35,34,19,53,26,21,47,0.6415094339622641,0.5531914893617021
437,Lake County Captains,2019,14,A,6,32,24,16,40,35,9,44,0.6,0.7954545454545454
437,Lake County Captains,2019,14,A,7,30,26,12,38,20,15,35,0.6842105263157895,0.5714285714285714
437,Lake County Captains,2019,14,A,8,33,31,12,43,20,13,33,0.7209302325581395,0.6060606060606061
437,Lake County Captains,2019,14,A,9,2,0,1,1,0,0,0,0.0,
440,Springfield Cardinals,2021,12,AA,5,28,16,8,24,41,10,51,0.6666666666666666,0.803921568627451
440,Springfield Cardinals,2021,12,AA,6,28,20,8,28,26,14,40,0.7142857142857143,0.65
440,Springfield Cardinals,2021,12,AA,7,34,13,10,23,38,9,47,0.5652173913043478,0.8085106382978723
440,Springfield Cardinals,2021,12,AA,8,5,2,2,4,0,0,0,0.5,
443,Peoria Chiefs,2019,14,A,4,12,4,2,6,0,2,2,0.6666666666666666,0.0
443,Peoria Chiefs,2019,14,A,5,40,22,10,32,18,19,37,0.6875,0.4864864864864865
443,Peoria Chiefs,2019,14,A,6,27,20,9,29,10,11,21,0.6896551724137931,0.47619047619047616
443,Peoria Chiefs,2019,14,A,7,28,5,9,14,33,13,46,0.35714285714285715,0.717391304347826
443,Peoria Chiefs,2019,14,A,8,33,17,12,29,44,13,57,0.5862068965517241,0.7719298245614035
443,Peoria Chiefs,2019,14,A,9,2,2,1,3,2,1,3,0.6666666666666666,0.6666666666666666
445,Columbus Clippers,2021,11,AAA,5,24,11,6,17,14,8,22,0.6470588235294118,0.6363636363636364
445,Columbus Clippers,2021,11,AAA,6,29,20,6,26,18,6,24,0.7692307692307693,0.75
445,Columbus Clippers,2021,11,AAA,7,28,13,5,18,13,3,16,0.7222222222222222,0.8125
445,Columbus Clippers,2021,11,AAA,8,33,27,7,34,28,6,34,0.7941176470588235,0.8235294117647058
445,Columbus Clippers,2021,11,AAA,9,30,9,2,11,21,11,32,0.8181818181818182,0.65625
445,Columbus Clippers,2021,11,AAA,10,3,0,1,1,1,0,1,0.0,1.0
446,Kane County Cougars,2019,14,A,4,7,6,0,6,8,0,8,1.0,1.0
446,Kane County Cougars,2019,14,A,5,31,27,12,39,26,19,45,0.6923076923076923,0.5777777777777777
446,Kane County Cougars,2019,14,A,6,30,22,5,27,23,8,31,0.8148148148148148,0.7419354838709677
446,Kane County Cougars,2019,14,A,7,28,19,9,28,23,13,36,0.6785714285714286,0.6388888888888888
446,Kane County Cougars,2019,14,A,8,30,22,7,29,16,22,38,0.7586206896551724,0.42105263157894735
446,Kane County Cougars,2019,14,A,9,2,1,1,2,0,1,1,0.5,0.0
448,Hickory Crawdads,2019,14,A,4,4,7,2,9,0,4,4,0.7777777777777778,0.0
448,Hickory Crawdads,2019,14,A,5,34,44,13,57,24,10,34,0.7719298245614035,0.7058823529411765
448,Hickory Crawdads,2019,14,A,6,33,18,13,31,4,8,12,0.5806451612903226,0.3333333333333333
448,Hickory Crawdads,2019,14,A,7,28,18,5,23,24,11,35,0.782608695652174,0.6857142857142857
448,Hickory Crawdads,2019,14,A,8,29,33,14,47,19,12,31,0.7021276595744681,0.6129032258064516
448,Hickory Crawdads,2019,14,A,9,2,4,2,6,1,0,1,0.6666666666666666,1.0
451,Iowa Cubs,2021,11,AAA,5,26,19,4,23,33,5,38,0.8260869565217391,0.868421052631579
451,Iowa Cubs,2021,11,AAA,6,30,25,6,31,22,7,29,0.8064516129032258,0.7586206896551724
451,Iowa Cubs,2021,11,AAA,7,33,18,7,25,14,10,24,0.72,0.5833333333333334
451,Iowa Cubs,2021,11,AAA,8,32,28,9,37,47,10,57,0.7567567567567568,0.8245614035087719
451,Iowa Cubs,2021,11,AAA,9,27,19,7,26,26,8,34,0.7307692307692307,0.7647058823529411
451,Iowa Cubs,2021,11,AAA,10,3,1,0,1,1,4,5,1.0,0.2
452,Altoona Curve,2021,12,AA,5,28,17,12,29,15,10,25,0.5862068965517241,0.6
452,Altoona Curve,2021,12,AA,6,31,25,8,33,32,2,34,0.7575757575757576,0.9411764705882353
452,Altoona Curve,2021,12,AA,7,35,22,17,39,31,2,33,0.5641025641025641,0.9393939393939394
452,Altoona Curve,2021,12,AA,8,4,0,1,1,4,1,5,0.0,0.8
456,Great Lakes Loons,2019,14,A,4,5,6,3,9,4,1,5,0.6666666666666666,0.8
456,Great Lakes Loons,2019,14,A,5,34,27,9,36,41,9,50,0.75,0.82
456,Great Lakes Loons,2019,14,A,6,31,10,6,16,34,11,45,0.625,0.7555555555555555
456,Great Lakes Loons,2019,14,A,7,28,33,8,41,10,11,21,0.8048780487804879,0.47619047619047616
456,Great Lakes Loons,2019,14,A,8,30,18,6,24,22,9,31,0.75,0.7096774193548387
456,Great Lakes Loons,2019,14,A,9,2,0,0,0,0,1,1,,0.0
459,Dayton Dragons,2019,14,A,4,5,4,1,5,2,1,3,0.8,0.6666666666666666
459,Dayton Dragons,2019,14,A,5,34,13,15,28,23,12,35,0.4642857142857143,0.6571428571428571
459,Dayton Dragons,2019,14,A,6,25,30,5,35,14,11,25,0.8571428571428571,0.56
459,Dayton Dragons,2019,14,A,7,28,20,13,33,26,10,36,0.6060606060606061,0.7222222222222222
459,Dayton Dragons,2019,14,A,8,33,29,11,40,27,12,39,0.725,0.6923076923076923
459,Dayton Dragons,2019,14,A,9,2,1,1,2,2,2,4,0.5,0.5
463,New Hampshire Fisher Cats,2021,12,AA,5,33,30,5,35,21,9,30,0.8571428571428571,0.7
463,New Hampshire Fisher Cats,2021,12,AA,6,32,31,13,44,14,14,28,0.7045454545454546,0.5
463,New Hampshire Fisher Cats,2021,12,AA,7,52,47,7,54,16,18,34,0.8703703703703703,0.47058823529411764
463,New Hampshire Fisher Cats,2021,12,AA,8,4,8,1,9,3,1,4,0.8888888888888888,0.75
464,GCL Braves,2019,16,Rookie,6,5,3,1,4,9,0,9,0.75,1.0
464,GCL Braves,2019,16,Rookie,7,53,37,10,47,98,14,112,0.7872340425531915,0.875
464,GCL Braves,2019,16,Rookie,8,50,21,10,31,34,9,43,0.6774193548387096,0.7906976744186046
466,GCL Nationals,2019,16,Rookie,6,8,9,3,12,5,3,8,0.75,0.625
466,GCL Nationals,2019,16,Rookie,7,31,37,16,53,31,14,45,0.6981132075471698,0.6888888888888889
466,GCL Nationals,2019,16,Rookie,8,42,29,9,38,38,8,46,0.7631578947368421,0.8260869565217391
467,GCL Marlins,2019,16,Rookie,6,6,12,1,13,5,1,6,0.9230769230769231,0.8333333333333334
467,GCL Marlins,2019,16,Rookie,7,25,39,7,46,25,5,30,0.8478260869565217,0.8333333333333334
467,GCL Marlins,2019,16,Rookie,8,45,94,19,113,32,5,37,0.831858407079646,0.8648648648648649
468,GCL Mets,2019,16,Rookie,6,5,6,3,9,4,0,4,0.6666666666666666,1.0
468,GCL Mets,2019,16,Rookie,7,26,28,17,45,19,25,44,0.6222222222222222,0.4318181818181818
468,GCL Mets,2019,16,Rookie,8,36,26,9,35,70,21,91,0.7428571428571429,0.7692307692307693
469,GCL Phillies East,2019,16,Rookie,6,5,8,1,9,2,3,5,0.8888888888888888,0.4
469,GCL Phillies East,2019,16,Rookie,7,35,43,31,74,67,16,83,0.581081081081081,0.8072289156626506
469,GCL Phillies East,2019,16,Rookie,8,44,18,9,27,58,6,64,0.6666666666666666,0.90625
470,GCL Pirates,2019,16,Rookie,6,6,5,3,8,12,4,16,0.625,0.75
470,GCL Pirates,2019,16,Rookie,7,30,39,16,55,37,10,47,0.7090909090909091,0.7872340425531915
470,GCL Pirates,2019,16,Rookie,8,47,45,15,60,43,18,61,0.75,0.7049180327868853
471,GCL Red Sox,2019,16,Rookie,6,5,5,1,6,3,0,3,0.8333333333333334,1.0
471,GCL Red Sox,2019,16,Rookie,7,35,34,6,40,28,17,45,0.85,0.6222222222222222
471,GCL Red Sox,2019,16,Rookie,8,52,17,15,32,74,14,88,0.53125,0.8409090909090909
473,FCL Tigers East,2019,16,Rookie,6,5,5,3,8,8,1,9,0.625,0.8888888888888888
473,FCL Tigers East,2019,16,Rookie,7,32,50,9,59,19,9,28,0.847457627118644,0.6785714285714286
473,FCL Tigers East,2019,16,Rookie,8,33,33,8,41,34,13,47,0.8048780487804879,0.723404255319149
474,GCL Twins,2019,16,Rookie,6,5,3,1,4,11,2,13,0.75,0.8461538461538461
474,GCL Twins,2019,16,Rookie,7,31,30,10,40,28,12,40,0.75,0.7
474,GCL Twins,2019,16,Rookie,8,59,61,7,68,14,12,26,0.8970588235294118,0.5384615384615384
475,GCL Yankees East,2019,16,Rookie,6,5,1,1,2,7,0,7,0.5,1.0
475,GCL Yankees East,2019,16,Rookie,7,32,36,11,47,50,21,71,0.7659574468085106,0.704225352112676
475,GCL Yankees East,2019,16,Rookie,8,38,20,11,31,27,23,50,0.6451612903225806,0.54
477,Greensboro Grasshoppers,2019,14,A,4,4,4,2,6,2,0,2,0.6666666666666666,1.0
477,Greensboro Grasshoppers,2019,14,A,5,36,55,17,72,43,8,51,0.7638888888888888,0.8431372549019608
477,Greensboro Grasshoppers,2019,14,A,6,29,28,15,43,26,6,32,0.6511627906976745,0.8125
477,Greensboro Grasshoppers,2019,14,A,7,34,37,21,58,36,8,44,0.6379310344827587,0.8181818181818182
477,Greensboro Grasshoppers,2019,14,A,8,29,30,16,46,29,6,35,0.6521739130434783,0.8285714285714286
477,Greensboro Grasshoppers,2019,14,A,9,2,0,0,0,0,1,1,,0.0
478,Augusta GreenJackets,2019,14,A,4,7,0,4,4,12,1,13,0.0,0.9230769230769231
478,Augusta GreenJackets,2019,14,A,5,34,16,4,20,33,17,50,0.8,0.66
478,Augusta GreenJackets,2019,14,A,6,30,9,2,11,26,14,40,0.8181818181818182,0.65
478,Augusta GreenJackets,2019,14,A,7,28,11,6,17,18,14,32,0.6470588235294118,0.5625
478,Augusta GreenJackets,2019,14,A,8,32,20,8,28,30,15,45,0.7142857142857143,0.6666666666666666
478,Augusta GreenJackets,2019,14,A,9,2,0,0,0,1,0,1,,1.0
482,Corpus Christi Hooks,2021,12,AA,5,31,32,15,47,27,17,44,0.6808510638297872,0.6136363636363636
482,Corpus Christi Hooks,2021,12,AA,6,29,26,17,43,19,7,26,0.6046511627906976,0.7307692307692307
482,Corpus Christi Hooks,2021,12,AA,7,32,14,13,27,35,12,47,0.5185185185185185,0.7446808510638298
482,Corpus Christi Hooks,2021,12,AA,8,3,3,2,5,4,1,5,0.6,0.8
484,Indianapolis Indians,2021,11,AAA,5,28,13,6,19,20,3,23,0.6842105263157895,0.8695652173913043
484,Indianapolis Indians,2021,11,AAA,6,29,14,4,18,17,8,25,0.7777777777777778,0.68
484,Indianapolis Indians,2021,11,AAA,7,30,11,5,16,24,8,32,0.6875,0.75
484,Indianapolis Indians,2021,11,AAA,8,28,18,7,25,16,13,29,0.72,0.5517241379310345
484,Indianapolis Indians,2021,11,AAA,9,27,20,3,23,11,8,19,0.8695652173913043,0.5789473684210527
484,Indianapolis Indians,2021,11,AAA,10,3,1,1,2,4,0,4,0.5,1.0
487,Kannapolis Intimidators,2019,14,A,4,4,5,3,8,5,2,7,0.625,0.7142857142857143
487,Kannapolis Intimidators,2019,14,A,5,36,17,10,27,41,16,57,0.6296296296296297,0.7192982456140351
487,Kannapolis Intimidators,2019,14,A,6,33,18,6,24,20,4,24,0.75,0.8333333333333334
487,Kannapolis Intimidators,2019,14,A,7,28,12,5,17,25,10,35,0.7058823529411765,0.7142857142857143
487,Kannapolis Intimidators,2019,14,A,8,32,23,10,33,29,16,45,0.696969696969697,0.6444444444444445
487,Kannapolis Intimidators,2019,14,A,9,2,0,0,0,2,0,2,,1.0
492,Cedar Rapids Kernels,2019,14,A,4,8,12,0,12,4,0,4,1.0,1.0
492,Cedar Rapids Kernels,2019,14,A,5,46,45,12,57,46,10,56,0.7894736842105263,0.8214285714285714
492,Cedar Rapids Kernels,2019,14,A,6,30,13,11,24,32,6,38,0.5416666666666666,0.8421052631578947
492,Cedar Rapids Kernels,2019,14,A,7,28,18,10,28,26,10,36,0.6428571428571429,0.7222222222222222
492,Cedar Rapids Kernels,2019,14,A,8,30,19,3,22,31,13,44,0.8636363636363636,0.7045454545454546
492,Cedar Rapids Kernels,2019,14,A,9,2,0,0,0,0,0,0,,
494,Charlotte Knights,2021,11,AAA,5,25,16,1,17,25,6,31,0.9411764705882353,0.8064516129032258
494,Charlotte Knights,2021,11,AAA,6,27,15,9,24,24,6,30,0.625,0.8
494,Charlotte Knights,2021,11,AAA,7,32,15,7,22,41,6,47,0.6818181818181818,0.8723404255319149
494,Charlotte Knights,2021,11,AAA,8,32,11,8,19,31,10,41,0.5789473684210527,0.7560975609756098
494,Charlotte Knights,2021,11,AAA,9,29,20,2,22,20,7,27,0.9090909090909091,0.7407407407407407
494,Charlotte Knights,2021,11,AAA,10,3,0,1,1,1,0,1,0.0,1.0
495,Lexington Legends,2019,14,A,4,4,3,1,4,2,1,3,0.75,0.6666666666666666
495,Lexington Legends,2019,14,A,5,36,42,15,57,10,13,23,0.7368421052631579,0.43478260869565216
495,Lexington Legends,2019,14,A,6,29,32,11,43,10,7,17,0.7441860465116279,0.5882352941176471
495,Lexington Legends,2019,14,A,7,32,31,16,47,23,15,38,0.6595744680851063,0.6052631578947368
495,Lexington Legends,2019,14,A,8,34,20,12,32,23,10,33,0.625,0.696969696969697
495,Lexington Legends,2019,14,A,9,2,1,0,1,4,2,6,1.0,0.6666666666666666
498,Chattanooga Lookouts,2021,12,AA,5,30,19,15,34,25,8,33,0.5588235294117647,0.7575757575757576
498,Chattanooga Lookouts,2021,12,AA,6,30,19,11,30,14,7,21,0.6333333333333333,0.6666666666666666
498,Chattanooga Lookouts,2021,12,AA,7,27,12,13,25,18,8,26,0.48,0.6923076923076923
498,Chattanooga Lookouts,2021,12,AA,8,4,2,1,3,1,2,3,0.6666666666666666,0.3333333333333333
499,Lansing Lugnuts,2019,14,A,4,5,4,4,8,6,2,8,0.5,0.75
499,Lansing Lugnuts,2019,14,A,5,32,49,23,72,24,12,36,0.6805555555555556,0.6666666666666666
499,Lansing Lugnuts,2019,14,A,6,30,39,12,51,30,15,45,0.7647058823529411,0.6666666666666666
499,Lansing Lugnuts,2019,14,A,7,28,30,14,44,22,7,29,0.6818181818181818,0.7586206896551724
499,Lansing Lugnuts,2019,14,A,8,33,29,9,38,22,11,33,0.7631578947368421,0.6666666666666666
499,Lansing Lugnuts,2019,14,A,9,2,3,0,3,0,1,1,1.0,0.0
500,Clinton LumberKings,2019,14,A,4,11,10,0,10,25,1,26,1.0,0.9615384615384616
500,Clinton LumberKings,2019,14,A,5,41,54,15,69,23,18,41,0.782608695652174,0.5609756097560976
500,Clinton LumberKings,2019,14,A,6,31,24,10,34,17,9,26,0.7058823529411765,0.6538461538461539
500,Clinton LumberKings,2019,14,A,7,30,25,14,39,30,11,41,0.6410256410256411,0.7317073170731707
500,Clinton LumberKings,2019,14,A,8,30,31,12,43,12,6,18,0.7209302325581395,0.6666666666666666
500,Clinton LumberKings,2019,14,A,9,2,2,1,3,2,1,3,0.6666666666666666,0.6666666666666666
505,Binghamton Rumble Ponies,2021,12,AA,5,33,6,3,9,25,18,43,0.6666666666666666,0.5813953488372093
505,Binghamton Rumble Ponies,2021,12,AA,6,27,18,7,25,16,6,22,0.72,0.7272727272727273
505,Binghamton Rumble Ponies,2021,12,AA,7,30,12,7,19,30,16,46,0.631578947368421,0.6521739130434783
505,Binghamton Rumble Ponies,2021,12,AA,8,6,1,2,3,4,1,5,0.3333333333333333,0.8
510,San Antonio Missions,2021,12,AA,5,27,27,14,41,26,8,34,0.6585365853658537,0.7647058823529411
510,San Antonio Missions,2021,12,AA,6,27,38,25,63,31,9,40,0.6031746031746031,0.775
510,San Antonio Missions,2021,12,AA,7,40,53,15,68,23,12,35,0.7794117647058824,0.6571428571428571
510,San Antonio Missions,2021,12,AA,8,5,5,5,10,7,2,9,0.5,0.7777777777777778
512,Toledo Mud Hens,2021,11,AAA,5,28,14,4,18,13,8,21,0.7777777777777778,0.6190476190476191
512,Toledo Mud Hens,2021,11,AAA,6,29,15,10,25,17,2,19,0.6,0.8947368421052632
512,Toledo Mud Hens,2021,11,AAA,7,28,17,9,26,16,7,23,0.6538461538461539,0.6956521739130435
512,Toledo Mud Hens,2021,11,AAA,8,34,16,3,19,20,13,33,0.8421052631578947,0.6060606060606061
512,Toledo Mud Hens,2021,11,AAA,9,29,9,1,10,14,2,16,0.9,0.875
512,Toledo Mud Hens,2021,11,AAA,10,3,4,0,4,1,0,1,1.0,1.0
522,Reading Fightin Phils,2021,12,AA,5,30,16,6,22,23,14,37,0.7272727272727273,0.6216216216216216
522,Reading Fightin Phils,2021,12,AA,6,29,7,4,11,25,6,31,0.6363636363636364,0.8064516129032258
522,Reading Fightin Phils,2021,12,AA,7,30,11,0,11,37,8,45,1.0,0.8222222222222222
522,Reading Fightin Phils,2021,12,AA,8,4,1,0,1,8,1,9,1.0,0.8888888888888888
525,West Virginia Power,2019,14,A,4,4,4,2,6,7,3,10,0.6666666666666666,0.7
525,West Virginia Power,2019,14,A,5,37,18,7,25,44,13,57,0.72,0.7719298245614035
525,West Virginia Power,2019,14,A,6,30,8,9,17,30,14,44,0.47058823529411764,0.6818181818181818
525,West Virginia Power,2019,14,A,7,28,5,3,8,29,10,39,0.625,0.7435897435897436
525,West Virginia Power,2019,14,A,8,32,8,4,12,26,7,33,0.6666666666666666,0.7878787878787878
525,West Virginia Power,2019,14,A,9,2,0,1,1,0,0,0,0.0,
529,Tacoma Rainiers,2021,11,AAA,5,23,18,2,20,16,7,23,0.9,0.6956521739130435
529,Tacoma Rainiers,2021,11,AAA,6,27,19,6,25,14,2,16,0.76,0.875
529,Tacoma Rainiers,2021,11,AAA,7,34,10,3,13,24,5,29,0.7692307692307693,0.8275862068965517
529,Tacoma Rainiers,2021,11,AAA,8,27,14,6,20,22,4,26,0.7,0.8461538461538461
529,Tacoma Rainiers,2021,11,AAA,9,28,24,4,28,23,5,28,0.8571428571428571,0.8214285714285714
529,Tacoma Rainiers,2021,11,AAA,10,3,6,0,6,3,0,3,1.0,1.0
531,Scranton/Wilkes-Barre RailRiders,2021,11,AAA,5,29,21,5,26,28,19,47,0.8076923076923077,0.5957446808510638
531,Scranton/Wilkes-Barre RailRiders,2021,11,AAA,6,31,29,11,40,26,4,30,0.725,0.8666666666666667
531,Scranton/Wilkes-Barre RailRiders,2021,11,AAA,7,39,56,17,73,31,9,40,0.7671232876712328,0.775
531,Scranton/Wilkes-Barre RailRiders,2021,11,AAA,8,32,34,11,45,21,5,26,0.7555555555555555,0.8076923076923077
531,Scranton/Wilkes-Barre RailRiders,2021,11,AAA,9,38,68,7,75,46,7,53,0.9066666666666666,0.8679245283018868
531,Scranton/Wilkes-Barre RailRiders,2021,11,AAA,10,3,3,1,4,0,0,0,0.75,
533,Worcester Red Sox,2021,11,AAA,5,27,44,6,50,26,8,34,0.88,0.7647058823529411
533,Worcester Red Sox,2021,11,AAA,6,27,24,5,29,21,9,30,0.8275862068965517,0.7
533,Worcester Red Sox,2021,11,AAA,7,40,36,4,40,45,9,54,0.9,0.8333333333333334
533,Worcester Red Sox,2021,11,AAA,8,33,32,5,37,34,11,45,0.8648648648648649,0.7555555555555555
533,Worcester Red Sox,2021,11,AAA,9,27,27,2,29,22,3,25,0.9310344827586207,0.88
533,Worcester Red Sox,2021,11,AAA,10,3,1,1,2,1,0,1,0.5,1.0
534,Rochester Red Wings,2021,11,AAA,5,27,9,3,12,39,8,47,0.75,0.8297872340425532
534,Rochester Red Wings,2021,11,AAA,6,30,9,9,18,17,6,23,0.5,0.7391304347826086
534,Rochester Red Wings,2021,11,AAA,7,40,12,4,16,15,9,24,0.75,0.625
534,Rochester Red Wings,2021,11,AAA,8,34,9,1,10,27,7,34,0.9,0.7941176470588235
534,Rochester Red Wings,2021,11,AAA,9,29,19,2,21,43,4,47,0.9047619047619048,0.9148936170212766
534,Rochester Red Wings,2021,11,AAA,10,3,0,0,0,3,1,4,,0.75
538,Hartford Yard Goats,2021,12,AA,5,27,20,14,34,23,5,28,0.5882352941176471,0.8214285714285714
538,Hartford Yard Goats,2021,12,AA,6,31,13,8,21,23,5,28,0.6190476190476191,0.8214285714285714
538,Hartford Yard Goats,2021,12,AA,7,34,29,9,38,22,5,27,0.7631578947368421,0.8148148148148148
538,Hartford Yard Goats,2021,12,AA,8,4,5,1,6,6,1,7,0.8333333333333334,0.8571428571428571
540,Frisco RoughRiders,2021,12,AA,5,28,28,12,40,20,14,34,0.7,0.5882352941176471
540,Frisco RoughRiders,2021,12,AA,6,31,21,8,29,46,20,66,0.7241379310344828,0.696969696969697
540,Frisco RoughRiders,2021,12,AA,7,27,34,9,43,23,8,31,0.7906976744186046,0.7419354838709677
540,Frisco RoughRiders,2021,12,AA,8,3,3,0,3,1,1,2,1.0,0.5
541,Omaha Storm Chasers,2021,11,AAA,5,28,40,7,47,18,8,26,0.851063829787234,0.6923076923076923
541,Omaha Storm Chasers,2021,11,AAA,6,29,21,4,25,20,4,24,0.84,0.8333333333333334
541,Omaha Storm Chasers,2021,11,AAA,7,31,32,9,41,15,8,23,0.7804878048780488,0.6521739130434783
541,Omaha Storm Chasers,2021,11,AAA,8,28,45,6,51,24,4,28,0.8823529411764706,0.8571428571428571
541,Omaha Storm Chasers,2021,11,AAA,9,26,20,10,30,11,3,14,0.6666666666666666,0.7857142857142857
541,Omaha Storm Chasers,2021,11,AAA,10,3,1,4,5,1,0,1,0.2,1.0
546,Portland Sea Dogs,2021,12,AA,5,27,6,8,14,23,8,31,0.42857142857142855,0.7419354838709677
546,Portland Sea Dogs,2021,12,AA,6,33,17,10,27,20,16,36,0.6296296296296297,0.5555555555555556
546,Portland Sea Dogs,2021,12,AA,7,55,14,16,30,33,2,35,0.4666666666666667,0.9428571428571428
546,Portland Sea Dogs,2021,12,AA,8,6,2,1,3,3,2,5,0.6666666666666666,0.6
547,Harrisburg Senators,2021,12,AA,5,33,10,8,18,17,7,24,0.5555555555555556,0.7083333333333334
547,Harrisburg Senators,2021,12,AA,6,31,7,5,12,16,4,20,0.5833333333333334,0.8
547,Harrisburg Senators,2021,12,AA,7,39,16,8,24,40,11,51,0.6666666666666666,0.7843137254901961
547,Harrisburg Senators,2021,12,AA,8,4,2,1,3,0,1,1,0.6666666666666666,0.0
548,Delmarva Shorebirds,2019,14,A,4,7,11,2,13,0,4,4,0.8461538461538461,0.0
548,Delmarva Shorebirds,2019,14,A,5,37,22,16,38,50,12,62,0.5789473684210527,0.8064516129032258
548,Delmarva Shorebirds,2019,14,A,6,27,10,7,17,19,11,30,0.5882352941176471,0.6333333333333333
548,Delmarva Shorebirds,2019,14,A,7,28,23,6,29,16,9,25,0.7931034482758621,0.64
548,Delmarva Shorebirds,2019,14,A,8,35,22,9,31,14,9,23,0.7096774193548387,0.6086956521739131
548,Delmarva Shorebirds,2019,14,A,9,2,2,0,2,0,0,0,1.0,
550,South Bend Cubs,2019,14,A,4,8,10,1,11,4,6,10,0.9090909090909091,0.4
550,South Bend Cubs,2019,14,A,5,32,21,14,35,17,18,35,0.6,0.4857142857142857
550,South Bend Cubs,2019,14,A,6,27,15,9,24,16,7,23,0.625,0.6956521739130435
550,South Bend Cubs,2019,14,A,7,31,15,8,23,28,9,37,0.6521739130434783,0.7567567567567568
550,South Bend Cubs,2019,14,A,8,33,5,4,9,18,8,26,0.5555555555555556,0.6923076923076923
550,South Bend Cubs,2019,14,A,9,2,1,0,1,1,0,1,1.0,1.0
552,Syracuse Mets,2021,11,AAA,5,27,45,8,53,24,7,31,0.8490566037735849,0.7741935483870968
552,Syracuse Mets,2021,11,AAA,6,34,36,10,46,31,10,41,0.782608695652174,0.7560975609756098
552,Syracuse Mets,2021,11,AAA,7,38,24,11,35,34,11,45,0.6857142857142857,0.7555555555555555
552,Syracuse Mets,2021,11,AAA,8,39,33,9,42,17,5,22,0.7857142857142857,0.7727272727272727
552,Syracuse Mets,2021,11,AAA,9,33,24,10,34,37,4,41,0.7058823529411765,0.9024390243902439
552,Syracuse Mets,2021,11,AAA,10,3,0,0,0,0,1,1,,0.0
553,Tennessee Smokies,2021,12,AA,5,25,19,7,26,23,15,38,0.7307692307692307,0.6052631578947368
553,Tennessee Smokies,2021,12,AA,6,30,15,7,22,33,8,41,0.6818181818181818,0.8048780487804879
553,Tennessee Smokies,2021,12,AA,7,30,18,5,23,20,7,27,0.782608695652174,0.7407407407407407
553,Tennessee Smokies,2021,12,AA,8,7,3,2,5,13,3,16,0.6,0.8125
554,Beloit Snappers,2019,14,A,4,12,0,2,2,8,4,12,0.0,0.6666666666666666
554,Beloit Snappers,2019,14,A,5,46,22,20,42,52,24,76,0.5238095238095238,0.6842105263157895
554,Beloit Snappers,2019,14,A,6,33,28,8,36,41,16,57,0.7777777777777778,0.7192982456140351
554,Beloit Snappers,2019,14,A,7,33,21,9,30,23,16,39,0.7,0.5897435897435898
554,Beloit Snappers,2019,14,A,8,30,49,19,68,35,11,46,0.7205882352941176,0.7608695652173914
554,Beloit Snappers,2019,14,A,9,2,0,0,0,0,0,0,,
556,Nashville Sounds,2021,11,AAA,5,28,15,6,21,22,6,28,0.7142857142857143,0.7857142857142857
556,Nashville Sounds,2021,11,AAA,6,27,20,4,24,20,7,27,0.8333333333333334,0.7407407407407407
556,Nashville Sounds,2021,11,AAA,7,33,17,6,23,24,9,33,0.7391304347826086,0.7272727272727273
556,Nashville Sounds,2021,11,AAA,8,31,20,6,26,23,10,33,0.7692307692307693,0.696969696969697
556,Nashville Sounds,2021,11,AAA,9,26,18,6,24,16,4,20,0.75,0.8
556,Nashville Sounds,2021,11,AAA,10,3,4,0,4,1,1,2,1.0,0.5
559,Rocket City Trash Pandas,2021,12,AA,5,27,19,8,27,23,15,38,0.7037037037037037,0.6052631578947368
559,Rocket City Trash Pandas,2021,12,AA,6,33,17,7,24,20,6,26,0.7083333333333334,0.7692307692307693
559,Rocket City Trash Pandas,2021,12,AA,7,44,36,19,55,54,8,62,0.6545454545454545,0.8709677419354839
559,Rocket City Trash Pandas,2021,12,AA,8,4,1,1,2,5,2,7,0.5,0.7142857142857143
561,Salt Lake Bees,2021,11,AAA,5,23,18,7,25,17,3,20,0.72,0.85
561,Salt Lake Bees,2021,11,AAA,6,26,15,7,22,9,6,15,0.6818181818181818,0.6
561,Salt Lake Bees,2021,11,AAA,7,31,26,4,30,14,1,15,0.8666666666666667,0.9333333333333333
561,Salt Lake Bees,2021,11,AAA,8,34,21,9,30,17,2,19,0.7,0.8947368421052632
561,Salt Lake Bees,2021,11,AAA,9,25,7,5,12,11,5,16,0.5833333333333334,0.6875
561,Salt Lake Bees,2021,11,AAA,10,3,3,0,3,6,0,6,1.0,1.0
563,Hagerstown Suns,2019,14,A,4,4,3,0,3,2,1,3,1.0,0.6666666666666666
563,Hagerstown Suns,2019,14,A,5,32,26,11,37,22,13,35,0.7027027027027027,0.6285714285714286
563,Hagerstown Suns,2019,14,A,6,33,32,15,47,19,23,42,0.6808510638297872,0.4523809523809524
563,Hagerstown Suns,2019,14,A,7,29,26,9,35,19,12,31,0.7428571428571429,0.6129032258064516
563,Hagerstown Suns,2019,14,A,8,37,28,22,50,24,21,45,0.56,0.5333333333333333
563,Hagerstown Suns,2019,14,A,9,2,2,3,5,1,0,1,0.4,1.0
564,Jacksonville Jumbo Shrimp,2021,11,AAA,5,27,20,13,33,17,6,23,0.6060606060606061,0.7391304347826086
564,Jacksonville Jumbo Shrimp,2021,11,AAA,6,32,33,4,37,30,11,41,0.8918918918918919,0.7317073170731707
564,Jacksonville Jumbo Shrimp,2021,11,AAA,7,38,34,7,41,19,9,28,0.8292682926829268,0.6785714285714286
564,Jacksonville Jumbo Shrimp,2021,11,AAA,8,35,28,12,40,41,12,53,0.7,0.7735849056603774
564,Jacksonville Jumbo Shrimp,2021,11,AAA,9,24,15,4,19,16,7,23,0.7894736842105263,0.6956521739130435
564,Jacksonville Jumbo Shrimp,2021,11,AAA,10,3,2,1,3,0,2,2,0.6666666666666666,0.0
565,Quad Cities River Bandits,2019,14,A,4,10,22,1,23,7,0,7,0.9565217391304348,1.0
565,Quad Cities River Bandits,2019,14,A,5,38,46,36,82,22,20,42,0.5609756097560976,0.5238095238095238
565,Quad Cities River Bandits,2019,14,A,6,30,32,13,45,22,10,32,0.7111111111111111,0.6875
565,Quad Cities River Bandits,2019,14,A,7,32,29,20,49,18,12,30,0.5918367346938775,0.6
565,Quad Cities River Bandits,2019,14,A,8,30,37,22,59,30,9,39,0.6271186440677966,0.7692307692307693
565,Quad Cities River Bandits,2019,14,A,9,2,8,1,9,5,1,6,0.8888888888888888,0.8333333333333334
568,Norfolk Tides,2021,11,AAA,5,25,18,5,23,11,7,18,0.782608695652174,0.6111111111111112
568,Norfolk Tides,2021,11,AAA,6,32,31,10,41,27,5,32,0.7560975609756098,0.84375
568,Norfolk Tides,2021,11,AAA,7,33,22,3,25,26,10,36,0.88,0.7222222222222222
568,Norfolk Tides,2021,11,AAA,8,41,44,14,58,22,9,31,0.7586206896551724,0.7096774193548387
568,Norfolk Tides,2021,11,AAA,9,31,11,9,20,22,5,27,0.55,0.8148148148148148
568,Norfolk Tides,2021,11,AAA,10,3,0,2,2,0,2,2,0.0,0.0
572,Wisconsin Timber Rattlers,2019,14,A,4,7,8,2,10,1,2,3,0.8,0.3333333333333333
572,Wisconsin Timber Rattlers,2019,14,A,5,37,45,14,59,31,19,50,0.7627118644067796,0.62
572,Wisconsin Timber Rattlers,2019,14,A,6,27,38,19,57,16,13,29,0.6666666666666666,0.5517241379310345
572,Wisconsin Timber Rattlers,2019,14,A,7,34,22,17,39,24,8,32,0.5641025641025641,0.75
572,Wisconsin Timber Rattlers,2019,14,A,8,33,38,12,50,30,12,42,0.76,0.7142857142857143
572,Wisconsin Timber Rattlers,2019,14,A,9,2,5,1,6,8,1,9,0.8333333333333334,0.8888888888888888
573,Asheville Tourists,2019,14,A,4,4,7,2,9,5,1,6,0.7777777777777778,0.8333333333333334
573,Asheville Tourists,2019,14,A,5,32,32,12,44,21,15,36,0.7272727272727273,0.5833333333333334
573,Asheville Tourists,2019,14,A,6,27,33,20,53,20,11,31,0.6226415094339622,0.6451612903225806
573,Asheville Tourists,2019,14,A,7,31,42,22,64,20,17,37,0.65625,0.5405405405405406
573,Asheville Tourists,2019,14,A,8,29,32,19,51,26,12,38,0.6274509803921569,0.6842105263157895
573,Asheville Tourists,2019,14,A,9,2,2,4,6,4,0,4,0.3333333333333333,1.0
574,Arkansas Travelers,2021,12,AA,5,28,17,10,27,43,11,54,0.6296296296296297,0.7962962962962963
574,Arkansas Travelers,2021,12,AA,6,26,29,10,39,35,11,46,0.7435897435897436,0.7608695652173914
574,Arkansas Travelers,2021,12,AA,7,34,24,8,32,41,9,50,0.75,0.82
574,Arkansas Travelers,2021,12,AA,8,7,0,1,1,15,3,18,0.0,0.8333333333333334
582,West Michigan Whitecaps,2019,14,A,4,5,6,2,8,6,1,7,0.75,0.8571428571428571
582,West Michigan Whitecaps,2019,14,A,5,36,25,19,44,33,8,41,0.5681818181818182,0.8048780487804879
582,West Michigan Whitecaps,2019,14,A,6,35,17,9,26,25,9,34,0.6538461538461539,0.7352941176470589
582,West Michigan Whitecaps,2019,14,A,7,33,22,7,29,13,12,25,0.7586206896551724,0.52
582,West Michigan Whitecaps,2019,14,A,8,30,33,17,50,28,6,34,0.66,0.8235294117647058
582,West Michigan Whitecaps,2019,14,A,9,2,2,2,4,1,1,2,0.5,0.5
584,Fort Wayne TinCaps,2019,14,A,4,7,4,4,8,10,1,11,0.5,0.9090909090909091
584,Fort Wayne TinCaps,2019,14,A,5,32,19,10,29,34,10,44,0.6551724137931034,0.7727272727272727
584,Fort Wayne TinCaps,2019,14,A,6,25,19,4,23,22,9,31,0.8260869565217391,0.7096774193548387
584,Fort Wayne TinCaps,2019,14,A,7,28,26,10,36,17,13,30,0.7222222222222222,0.5666666666666667
584,Fort Wayne TinCaps,2019,14,A,8,30,23,9,32,22,14,36,0.71875,0.6111111111111112
584,Fort Wayne TinCaps,2019,14,A,9,2,0,1,1,3,0,3,0.0,1.0
599,GCL Orioles,2019,16,Rookie,6,6,19,3,22,3,1,4,0.8636363636363636,0.75
599,GCL Orioles,2019,16,Rookie,7,41,107,15,122,36,8,44,0.8770491803278688,0.8181818181818182
599,GCL Orioles,2019,16,Rookie,8,57,37,20,57,25,6,31,0.6491228070175439,0.8064516129032258
600,DSL Angels,2019,16,Rookie,6,22,37,15,52,29,19,48,0.7115384615384616,0.6041666666666666
600,DSL Angels,2019,16,Rookie,7,21,31,18,49,36,12,48,0.6326530612244898,0.75
600,DSL Angels,2019,16,Rookie,8,22,26,9,35,38,21,59,0.7428571428571429,0.6440677966101694
601,DSL Astros,2019,16,Rookie,6,26,60,27,87,34,20,54,0.6896551724137931,0.6296296296296297
601,DSL Astros,2019,16,Rookie,7,25,35,17,52,21,18,39,0.6730769230769231,0.5384615384615384
601,DSL Astros,2019,16,Rookie,8,26,40,15,55,30,15,45,0.7272727272727273,0.6666666666666666
602,DSL Athletics,2019,16,Rookie,6,25,34,15,49,50,13,63,0.6938775510204082,0.7936507936507936
602,DSL Athletics,2019,16,Rookie,7,29,41,17,58,56,26,82,0.7068965517241379,0.6829268292682927
602,DSL Athletics,2019,16,Rookie,8,37,38,10,48,101,19,120,0.7916666666666666,0.8416666666666667
604,DSL Blue Jays,2019,16,Rookie,6,25,52,19,71,35,17,52,0.7323943661971831,0.6730769230769231
604,DSL Blue Jays,2019,16,Rookie,7,22,50,16,66,34,12,46,0.7575757575757576,0.7391304347826086
604,DSL Blue Jays,2019,16,Rookie,8,21,39,15,54,48,10,58,0.7222222222222222,0.8275862068965517
605,DSL Braves,2019,16,Rookie,6,25,46,24,70,49,14,63,0.6571428571428571,0.7777777777777778
605,DSL Braves,2019,16,Rookie,7,23,25,14,39,39,15,54,0.6410256410256411,0.7222222222222222
605,DSL Braves,2019,16,Rookie,8,24,32,10,42,32,12,44,0.7619047619047619,0.7272727272727273
607,DSL Brewers,2019,16,Rookie,6,26,53,17,70,45,21,66,0.7571428571428571,0.6818181818181818
607,DSL Brewers,2019,16,Rookie,7,26,44,20,64,40,32,72,0.6875,0.5555555555555556
607,DSL Brewers,2019,16,Rookie,8,23,22,9,31,28,20,48,0.7096774193548387,0.5833333333333334
608,DSL Cardinals Blue,2019,16,Rookie,6,25,35,11,46,39,20,59,0.7608695652173914,0.6610169491525424
608,DSL Cardinals Blue,2019,16,Rookie,7,22,19,12,31,19,10,29,0.6129032258064516,0.6551724137931034
608,DSL Cardinals Blue,2019,16,Rookie,8,21,36,11,47,21,14,35,0.7659574468085106,0.6
609,DSL Cubs 1,2019,16,Rookie,6,26,59,23,82,43,13,56,0.7195121951219512,0.7678571428571429
609,DSL Cubs 1,2019,16,Rookie,7,25,54,26,80,19,12,31,0.675,0.6129032258064516
609,DSL Cubs 1,2019,16,Rookie,8,21,54,24,78,28,12,40,0.6923076923076923,0.7
610,DSL D-backs 1,2019,16,Rookie,6,25,35,20,55,36,15,51,0.6363636363636364,0.7058823529411765
610,DSL D-backs 1,2019,16,Rookie,7,24,38,21,59,41,19,60,0.6440677966101694,0.6833333333333333
610,DSL D-backs 1,2019,16,Rookie,8,23,45,13,58,23,24,47,0.7758620689655172,0.48936170212765956
611,DSL LAD Bautista,2019,16,Rookie,6,25,39,7,46,38,18,56,0.8478260869565217,0.6785714285714286
611,DSL LAD Bautista,2019,16,Rookie,7,30,39,19,58,23,22,45,0.6724137931034483,0.5111111111111111
611,DSL LAD Bautista,2019,16,Rookie,8,32,30,23,53,27,22,49,0.5660377358490566,0.5510204081632653
612,DSL Dodgers Shoemaker,2019,16,Rookie,6,25,38,14,52,40,13,53,0.7307692307692307,0.7547169811320755
612,DSL Dodgers Shoemaker,2019,16,Rookie,7,23,28,10,38,28,18,46,0.7368421052631579,0.6086956521739131
612,DSL Dodgers Shoemaker,2019,16,Rookie,8,26,17,18,35,29,19,48,0.4857142857142857,0.6041666666666666
615,DSL Giants,2019,16,Rookie,6,26,33,21,54,50,24,74,0.6111111111111112,0.6756756756756757
615,DSL Giants,2019,16,Rookie,7,26,24,17,41,36,31,67,0.5853658536585366,0.5373134328358209
615,DSL Giants,2019,16,Rookie,8,23,36,9,45,35,19,54,0.8,0.6481481481481481
616,DSL Indians,2019,16,Rookie,6,25,42,10,52,43,20,63,0.8076923076923077,0.6825396825396826
616,DSL Indians,2019,16,Rookie,7,30,12,22,34,42,16,58,0.35294117647058826,0.7241379310344828
616,DSL Indians,2019,16,Rookie,8,30,23,12,35,34,8,42,0.6571428571428571,0.8095238095238095
617,DSL Indians/Brewers,2019,16,Rookie,6,25,26,22,48,51,19,70,0.5416666666666666,0.7285714285714285
617,DSL Indians/Brewers,2019,16,Rookie,7,25,31,20,51,40,17,57,0.6078431372549019,0.7017543859649122
617,DSL Indians/Brewers,2019,16,Rookie,8,30,17,21,38,34,15,49,0.4473684210526316,0.6938775510204082
618,DSL Mariners,2019,16,Rookie,6,25,37,9,46,49,13,62,0.8043478260869565,0.7903225806451613
618,DSL Mariners,2019,16,Rookie,7,27,36,16,52,53,34,87,0.6923076923076923,0.6091954022988506
618,DSL Mariners,2019,16,Rookie,8,23,26,12,38,38,22,60,0.6842105263157895,0.6333333333333333
619,DSL Marlins,2019,16,Rookie,6,26,38,13,51,44,21,65,0.7450980392156863,0.676923076923077
619,DSL Marlins,2019,16,Rookie,7,27,13,11,24,46,18,64,0.5416666666666666,0.71875
619,DSL Marlins,2019,16,Rookie,8,34,56,9,65,38,12,50,0.8615384615384616,0.76
620,DSL Mets 1,2019,16,Rookie,6,22,24,12,36,34,20,54,0.6666666666666666,0.6296296296296297
620,DSL Mets 1,2019,16,Rookie,7,20,40,17,57,37,12,49,0.7017543859649122,0.7551020408163265
620,DSL Mets 1,2019,16,Rookie,8,22,36,13,49,33,16,49,0.7346938775510204,0.673469387755102
621,DSL Orioles 1,2019,16,Rookie,6,25,24,9,33,32,15,47,0.7272727272727273,0.6808510638297872
621,DSL Orioles 1,2019,16,Rookie,7,22,22,11,33,26,19,45,0.6666666666666666,0.5777777777777777
621,DSL Orioles 1,2019,16,Rookie,8,21,20,14,34,30,8,38,0.5882352941176471,0.7894736842105263
622,DSL Padres,2019,16,Rookie,6,25,40,20,60,34,17,51,0.6666666666666666,0.6666666666666666
622,DSL Padres,2019,16,Rookie,7,23,28,15,43,36,18,54,0.6511627906976745,0.6666666666666666
622,DSL Padres,2019,16,Rookie,8,23,38,16,54,38,11,49,0.7037037037037037,0.7755102040816326
623,DSL Phillies Red,2019,16,Rookie,6,22,38,28,66,36,19,55,0.5757575757575758,0.6545454545454545
623,DSL Phillies Red,2019,16,Rookie,7,22,38,14,52,34,22,56,0.7307692307692307,0.6071428571428571
623,DSL Phillies Red,2019,16,Rookie,8,20,29,16,45,26,12,38,0.6444444444444445,0.6842105263157895
624,DSL Pirates 1,2019,16,Rookie,6,25,28,17,45,38,16,54,0.6222222222222222,0.7037037037037037
624,DSL Pirates 1,2019,16,Rookie,7,22,27,9,36,26,12,38,0.75,0.6842105263157895
624,DSL Pirates 1,2019,16,Rookie,8,21,45,9,54,24,15,39,0.8333333333333334,0.6153846153846154
625,DSL Rangers 1,2019,16,Rookie,6,26,29,7,36,22,15,37,0.8055555555555556,0.5945945945945946
625,DSL Rangers 1,2019,16,Rookie,7,24,38,17,55,23,20,43,0.6909090909090909,0.5348837209302325
625,DSL Rangers 1,2019,16,Rookie,8,24,33,6,39,23,14,37,0.8461538461538461,0.6216216216216216
626,DSL Red Sox 1,2019,16,Rookie,6,25,54,15,69,48,22,70,0.782608695652174,0.6857142857142857
626,DSL Red Sox 1,2019,16,Rookie,7,23,33,24,57,37,12,49,0.5789473684210527,0.7551020408163265
626,DSL Red Sox 1,2019,16,Rookie,8,26,28,23,51,43,17,60,0.5490196078431373,0.7166666666666667
627,DSL Red Sox 2,2019,16,Rookie,6,27,36,19,55,44,24,68,0.6545454545454545,0.6470588235294118
627,DSL Red Sox 2,2019,16,Rookie,7,27,19,14,33,51,26,77,0.5757575757575758,0.6623376623376623
627,DSL Red Sox 2,2019,16,Rookie,8,23,15,7,22,44,18,62,0.6818181818181818,0.7096774193548387
628,DSL Reds,2019,16,Rookie,6,25,44,20,64,33,17,50,0.6875,0.66
628,DSL Reds,2019,16,Rookie,7,22,41,21,62,27,19,46,0.6612903225806451,0.5869565217391305
628,DSL Reds,2019,16,Rookie,8,21,39,13,52,24,14,38,0.75,0.631578947368421
629,DSL Rockies,2019,16,Rookie,6,23,78,23,101,35,12,47,0.7722772277227723,0.7446808510638298
629,DSL Rockies,2019,16,Rookie,7,20,42,24,66,30,13,43,0.6363636363636364,0.6976744186046512
629,DSL Rockies,2019,16,Rookie,8,18,40,20,60,20,11,31,0.6666666666666666,0.6451612903225806
630,DSL Royals 1,2019,16,Rookie,6,25,41,19,60,60,17,77,0.6833333333333333,0.7792207792207793
630,DSL Royals 1,2019,16,Rookie,7,23,49,18,67,24,13,37,0.7313432835820896,0.6486486486486487
630,DSL Royals 1,2019,16,Rookie,8,27,67,16,83,31,5,36,0.8072289156626506,0.8611111111111112
631,DSL Tigers 1,2019,16,Rookie,6,26,28,19,47,40,14,54,0.5957446808510638,0.7407407407407407
631,DSL Tigers 1,2019,16,Rookie,7,29,35,26,61,36,19,55,0.5737704918032787,0.6545454545454545
631,DSL Tigers 1,2019,16,Rookie,8,23,33,23,56,24,20,44,0.5892857142857143,0.5454545454545454
632,DSL Twins,2019,16,Rookie,6,26,28,17,45,36,11,47,0.6222222222222222,0.7659574468085106
632,DSL Twins,2019,16,Rookie,7,20,32,8,40,29,11,40,0.8,0.725
632,DSL Twins,2019,16,Rookie,8,18,26,14,40,28,16,44,0.65,0.6363636363636364
633,DSL White Sox,2019,16,Rookie,6,25,25,14,39,50,21,71,0.6410256410256411,0.704225352112676
633,DSL White Sox,2019,16,Rookie,7,23,32,19,51,47,16,63,0.6274509803921569,0.746031746031746
633,DSL White Sox,2019,16,Rookie,8,21,17,10,27,35,14,49,0.6296296296296297,0.7142857142857143
634,DSL Yankees,2019,16,Rookie,6,22,31,16,47,39,14,53,0.6595744680851063,0.7358490566037735
634,DSL Yankees,2019,16,Rookie,7,20,45,12,57,36,10,46,0.7894736842105263,0.782608695652174
634,DSL Yankees,2019,16,Rookie,8,19,34,18,52,34,8,42,0.6538461538461539,0.8095238095238095
1270,DSL Nationals,2019,16,Rookie,6,22,34,9,43,32,18,50,0.7906976744186046,0.64
1270,DSL Nationals,2019,16,Rookie,7,20,21,11,32,36,21,57,0.65625,0.631578947368421
1270,DSL Nationals,2019,16,Rookie,8,19,17,11,28,33,16,49,0.6071428571428571,0.673469387755102
1350,Northwest Arkansas Naturals,2021,12,AA,5,32,70,13,83,23,6,29,0.8433734939759037,0.7931034482758621
1350,Northwest Arkansas Naturals,2021,12,AA,6,29,42,19,61,14,12,26,0.6885245901639344,0.5384615384615384
1350,Northwest Arkansas Naturals,2021,12,AA,7,32,42,11,53,12,8,20,0.7924528301886793,0.6
1350,Northwest Arkansas Naturals,2021,12,AA,8,5,13,2,15,3,1,4,0.8666666666666667,0.75
1370,GCL Cardinals,2019,16,Rookie,6,7,0,1,1,14,2,16,0.0,0.875
1370,GCL Cardinals,2019,16,Rookie,7,24,13,16,29,37,13,50,0.4482758620689655,0.74
1370,GCL Cardinals,2019,16,Rookie,8,31,22,13,35,27,14,41,0.6285714285714286,0.6585365853658537
1390,GCL Blue Jays,2019,16,Rookie,6,6,11,6,17,3,0,3,0.6470588235294118,1.0
1390,GCL Blue Jays,2019,16,Rookie,7,31,68,11,79,31,18,49,0.8607594936708861,0.6326530612244898
1390,GCL Blue Jays,2019,16,Rookie,8,34,56,32,88,31,13,44,0.6363636363636364,0.7045454545454546
1410,Lehigh Valley IronPigs,2021,11,AAA,5,27,16,8,24,29,2,31,0.6666666666666666,0.9354838709677419
1410,Lehigh Valley IronPigs,2021,11,AAA,6,29,10,7,17,13,13,26,0.5882352941176471,0.5
1410,Lehigh Valley IronPigs,2021,11,AAA,7,44,18,6,24,19,4,23,0.75,0.8260869565217391
1410,Lehigh Valley IronPigs,2021,11,AAA,8,32,19,4,23,28,6,34,0.8260869565217391,0.8235294117647058
1410,Lehigh Valley IronPigs,2021,11,AAA,9,33,32,5,37,39,12,51,0.8648648648648649,0.7647058823529411
1410,Lehigh Valley IronPigs,2021,11,AAA,10,3,1,0,1,1,1,2,1.0,0.5
1611,DSL Rays 1,2019,16,Rookie,6,25,45,19,64,34,14,48,0.703125,0.7083333333333334
1611,DSL Rays 1,2019,16,Rookie,7,24,44,21,65,33,17,50,0.676923076923077,0.66
1611,DSL Rays 1,2019,16,Rookie,8,26,44,13,57,33,17,50,0.7719298245614035,0.66
1956,Somerset Patriots,2021,12,AA,5,30,29,10,39,25,8,33,0.7435897435897436,0.7575757575757576
1956,Somerset Patriots,2021,12,AA,6,34,38,13,51,31,4,35,0.7450980392156863,0.8857142857142857
1956,Somerset Patriots,2021,12,AA,7,39,53,11,64,19,11,30,0.828125,0.6333333333333333
1956,Somerset Patriots,2021,12,AA,8,4,12,2,14,2,1,3,0.8571428571428571,0.6666666666666666
1960,St. Paul Saints,2021,11,AAA,5,30,22,8,30,20,3,23,0.7333333333333333,0.8695652173913043
1960,St. Paul Saints,2021,11,AAA,6,35,17,6,23,21,8,29,0.7391304347826086,0.7241379310344828
1960,St. Paul Saints,2021,11,AAA,7,30,10,5,15,22,9,31,0.6666666666666666,0.7096774193548387
1960,St. Paul Saints,2021,11,AAA,8,33,36,17,53,22,3,25,0.6792452830188679,0.88
1960,St. Paul Saints,2021,11,AAA,9,30,16,10,26,12,4,16,0.6153846153846154,0.75
1960,St. Paul Saints,2021,11,AAA,10,3,1,0,1,4,0,4,1.0,1.0
1991,ACL D-backs,2019,16,Rookie,6,12,22,8,30,16,6,22,0.7333333333333333,0.7272727272727273
1991,ACL D-backs,2019,16,Rookie,7,22,47,13,60,25,14,39,0.7833333333333333,0.6410256410256411
1991,ACL D-backs,2019,16,Rookie,8,22,60,16,76,28,8,36,0.7894736842105263,0.7777777777777778
1995,AZL Cubs 2,2019,16,Rookie,6,11,8,5,13,9,5,14,0.6153846153846154,0.6428571428571429
1995,AZL Cubs 2,2019,16,Rookie,7,20,22,3,25,22,9,31,0.88,0.7096774193548387
1995,AZL Cubs 2,2019,16,Rookie,8,21,25,7,32,39,11,50,0.78125,0.78
1997,ACL White Sox,2019,16,Rookie,6,12,7,4,11,18,8,26,0.6363636363636364,0.6923076923076923
1997,ACL White Sox,2019,16,Rookie,7,21,18,6,24,25,8,33,0.75,0.7575757575757576
1997,ACL White Sox,2019,16,Rookie,8,20,12,7,19,23,8,31,0.631578947368421,0.7419354838709677
1998,GCL Astros,2019,16,Rookie,6,8,9,4,13,8,6,14,0.6923076923076923,0.5714285714285714
1998,GCL Astros,2019,16,Rookie,7,26,23,8,31,28,7,35,0.7419354838709677,0.8
1998,GCL Astros,2019,16,Rookie,8,40,25,10,35,29,12,41,0.7142857142857143,0.7073170731707317
2003,GCL Rays,2019,16,Rookie,6,5,5,0,5,2,2,4,1.0,0.5
2003,GCL Rays,2019,16,Rookie,7,30,18,13,31,38,9,47,0.5806451612903226,0.8085106382978723
2003,GCL Rays,2019,16,Rookie,8,55,38,12,50,29,20,49,0.76,0.5918367346938775
2097,DSL Cardinals Red,2019,16,Rookie,6,25,45,12,57,68,26,94,0.7894736842105263,0.723404255319149
2097,DSL Cardinals Red,2019,16,Rookie,7,26,38,13,51,44,20,64,0.7450980392156863,0.6875
2097,DSL Cardinals Red,2019,16,Rookie,8,21,45,12,57,23,14,37,0.7894736842105263,0.6216216216216216
2117,DSL Mets 2,2019,16,Rookie,6,25,32,19,51,50,20,70,0.6274509803921569,0.7142857142857143
2117,DSL Mets 2,2019,16,Rookie,7,24,28,19,47,49,20,69,0.5957446808510638,0.7101449275362319
2117,DSL Mets 2,2019,16,Rookie,8,21,32,18,50,41,16,57,0.64,0.7192982456140351
2128,DSL Royals 2,2019,16,Rookie,6,26,42,29,71,51,33,84,0.5915492957746479,0.6071428571428571
2128,DSL Royals 2,2019,16,Rookie,7,25,36,28,64,34,22,56,0.5625,0.6071428571428571
2128,DSL Royals 2,2019,16,Rookie,8,24,32,23,55,47,15,62,0.5818181818181818,0.7580645161290323
2131,DSL Colorado,2019,16,Rookie,6,25,47,26,73,35,21,56,0.6438356164383562,0.625
2131,DSL Colorado,2019,16,Rookie,7,23,49,28,77,26,23,49,0.6363636363636364,0.5306122448979592
2131,DSL Colorado,2019,16,Rookie,8,21,37,30,67,30,13,43,0.5522388059701493,0.6976744186046512
2132,DSL Tigers 2,2019,16,Rookie,6,25,43,29,72,40,9,49,0.5972222222222222,0.8163265306122449
2132,DSL Tigers 2,2019,16,Rookie,7,28,35,40,75,47,14,61,0.4666666666666667,0.7704918032786885
2132,DSL Tigers 2,2019,16,Rookie,8,25,44,18,62,38,15,53,0.7096774193548387,0.7169811320754716
2270,DSL Cubs 2,2019,16,Rookie,6,26,82,26,108,24,12,36,0.7592592592592593,0.6666666666666666
2270,DSL Cubs 2,2019,16,Rookie,7,26,66,35,101,25,16,41,0.6534653465346535,0.6097560975609756
2270,DSL Cubs 2,2019,16,Rookie,8,21,30,18,48,27,18,45,0.625,0.6
2310,Reno Aces,2021,11,AAA,5,23,17,3,20,27,4,31,0.85,0.8709677419354839
2310,Reno Aces,2021,11,AAA,6,25,13,6,19,4,7,11,0.6842105263157895,0.36363636363636365
2310,Reno Aces,2021,11,AAA,7,30,21,10,31,18,5,23,0.6774193548387096,0.782608695652174
2310,Reno Aces,2021,11,AAA,8,36,26,8,34,25,8,33,0.7647058823529411,0.7575757575757576
2310,Reno Aces,2021,11,AAA,9,25,23,9,32,16,5,21,0.71875,0.7619047619047619
2310,Reno Aces,2021,11,AAA,10,3,0,0,0,0,0,0,,
2413,DSL Rangers 2,2019,16,Rookie,6,25,29,3,32,60,15,75,0.90625,0.8
2413,DSL Rangers 2,2019,16,Rookie,7,24,30,7,37,44,21,65,0.8108108108108109,0.676923076923077
2413,DSL Rangers 2,2019,16,Rookie,8,23,16,13,29,35,19,54,0.5517241379310345,0.6481481481481481
2498,Bowling Green Hot Rods,2019,14,A,4,5,2,2,4,8,2,10,0.5,0.8
2498,Bowling Green Hot Rods,2019,14,A,5,32,30,10,40,27,8,35,0.75,0.7714285714285715
2498,Bowling Green Hot Rods,2019,14,A,6,37,37,15,52,15,5,20,0.7115384615384616,0.75
2498,Bowling Green Hot Rods,2019,14,A,7,31,26,8,34,26,8,34,0.7647058823529411,0.7647058823529411
2498,Bowling Green Hot Rods,2019,14,A,8,36,13,16,29,22,11,33,0.4482758620689655,0.6666666666666666
2498,Bowling Green Hot Rods,2019,14,A,9,2,1,0,1,1,0,1,1.0,1.0
2690,AZL Dodgers Mota,2019,16,Rookie,6,11,17,3,20,12,8,20,0.85,0.6
2690,AZL Dodgers Mota,2019,16,Rookie,7,21,40,14,54,21,6,27,0.7407407407407407,0.7777777777777778
2690,AZL Dodgers Mota,2019,16,Rookie,8,24,52,8,60,31,15,46,0.8666666666666667,0.6739130434782609
2770,AZL Indians Red,2019,16,Rookie,6,11,15,3,18,14,6,20,0.8333333333333334,0.7
2770,AZL Indians Red,2019,16,Rookie,7,21,40,10,50,20,13,33,0.8,0.6060606060606061
2770,AZL Indians Red,2019,16,Rookie,8,21,21,16,37,27,12,39,0.5675675675675675,0.6923076923076923
3130,DSL Orioles 2,2019,16,Rookie,6,22,14,11,25,39,9,48,0.56,0.8125
3130,DSL Orioles 2,2019,16,Rookie,7,21,16,6,22,27,11,38,0.7272727272727273,0.7105263157894737
3130,DSL Orioles 2,2019,16,Rookie,8,19,16,12,28,27,10,37,0.5714285714285714,0.7297297297297297
3410,Richmond Flying Squirrels,2021,12,AA,5,33,30,9,39,10,15,25,0.7692307692307693,0.4
3410,Richmond Flying Squirrels,2021,12,AA,6,29,19,6,25,22,7,29,0.76,0.7586206896551724
3410,Richmond Flying Squirrels,2021,12,AA,7,33,16,6,22,16,13,29,0.7272727272727273,0.5517241379310345
3410,Richmond Flying Squirrels,2021,12,AA,8,4,1,0,1,1,1,2,1.0,0.5
3430,AZL Reds,2019,16,Rookie,6,11,12,5,17,11,2,13,0.7058823529411765,0.8461538461538461
3430,AZL Reds,2019,16,Rookie,7,21,10,9,19,27,9,36,0.5263157894736842,0.75
3430,AZL Reds,2019,16,Rookie,8,21,28,9,37,16,14,30,0.7567567567567568,0.5333333333333333
3705,Columbia Fireflies,2019,14,A,4,4,2,0,2,1,3,4,1.0,0.25
3705,Columbia Fireflies,2019,14,A,5,34,8,14,22,30,12,42,0.36363636363636365,0.7142857142857143
3705,Columbia Fireflies,2019,14,A,6,33,9,6,15,18,12,30,0.6,0.6
3705,Columbia Fireflies,2019,14,A,7,31,15,9,24,24,7,31,0.625,0.7741935483870968
3705,Columbia Fireflies,2019,14,A,8,35,19,16,35,29,21,50,0.5428571428571428,0.58
3705,Columbia Fireflies,2019,14,A,9,2,1,0,1,0,0,0,1.0,
3898,Wichita Wind Surge,2021,12,AA,5,24,16,8,24,24,11,35,0.6666666666666666,0.6857142857142857
3898,Wichita Wind Surge,2021,12,AA,6,29,28,17,45,28,7,35,0.6222222222222222,0.8
3898,Wichita Wind Surge,2021,12,AA,7,27,19,11,30,29,11,40,0.6333333333333333,0.725
3898,Wichita Wind Surge,2021,12,AA,8,3,4,1,5,5,2,7,0.8,0.7142857142857143
4124,Pensacola Blue Wahoos,2021,12,AA,5,27,13,7,20,29,7,36,0.65,0.8055555555555556
4124,Pensacola Blue Wahoos,2021,12,AA,6,29,8,11,19,23,13,36,0.42105263157894735,0.6388888888888888
4124,Pensacola Blue Wahoos,2021,12,AA,7,33,21,5,26,23,7,30,0.8076923076923077,0.7666666666666667
4124,Pensacola Blue Wahoos,2021,12,AA,8,3,2,1,3,1,2,3,0.6666666666666666,0.3333333333333333
4404,DSL Pirates 2,2019,16,Rookie,6,25,55,14,69,32,28,60,0.7971014492753623,0.5333333333333333
4404,DSL Pirates 2,2019,16,Rookie,7,23,34,14,48,18,19,37,0.7083333333333334,0.4864864864864865
4404,DSL Pirates 2,2019,16,Rookie,8,24,40,17,57,27,25,52,0.7017543859649122,0.5192307692307693
4725,GCL Yankees West,2019,16,Rookie,6,5,6,2,8,6,2,8,0.75,0.75
4725,GCL Yankees West,2019,16,Rookie,7,28,21,8,29,39,7,46,0.7241379310344828,0.8478260869565217
4725,GCL Yankees West,2019,16,Rookie,8,34,34,14,48,23,10,33,0.7083333333333334,0.696969696969697
4904,El Paso Chihuahuas,2021,11,AAA,5,28,27,8,35,25,2,27,0.7714285714285715,0.9259259259259259
4904,El Paso Chihuahuas,2021,11,AAA,6,28,23,9,32,31,11,42,0.71875,0.7380952380952381
4904,El Paso Chihuahuas,2021,11,AAA,7,40,37,11,48,19,8,27,0.7708333333333334,0.7037037037037037
4904,El Paso Chihuahuas,2021,11,AAA,8,33,29,5,34,27,8,35,0.8529411764705882,0.7714285714285715
4904,El Paso Chihuahuas,2021,11,AAA,9,27,38,12,50,22,4,26,0.76,0.8461538461538461
4904,El Paso Chihuahuas,2021,11,AAA,10,3,3,0,3,5,1,6,1.0,0.8333333333333334
5015,Biloxi Shuckers,2021,12,AA,5,30,29,14,43,18,6,24,0.6744186046511628,0.75
5015,Biloxi Shuckers,2021,12,AA,6,37,21,15,36,24,13,37,0.5833333333333334,0.6486486486486487
5015,Biloxi Shuckers,2021,12,AA,7,38,18,9,27,30,20,50,0.6666666666666666,0.6
5015,Biloxi Shuckers,2021,12,AA,8,3,1,1,2,2,0,2,0.5,1.0
5071,GCL Tigers West,2019,16,Rookie,6,5,4,0,4,8,7,15,1.0,0.5333333333333333
5071,GCL Tigers West,2019,16,Rookie,7,25,22,8,30,30,11,41,0.7333333333333333,0.7317073170731707
5071,GCL Tigers West,2019,16,Rookie,8,36,26,2,28,17,10,27,0.9285714285714286,0.6296296296296297
5085,DSL Phillies White,2019,16,Rookie,6,25,48,22,70,41,15,56,0.6857142857142857,0.7321428571428571
5085,DSL Phillies White,2019,16,Rookie,7,25,39,21,60,48,19,67,0.65,0.7164179104477612
5085,DSL Phillies White,2019,16,Rookie,8,23,29,25,54,20,12,32,0.5370370370370371,0.625
5086,DSL Rays 2,2019,16,Rookie,6,25,45,20,65,22,12,34,0.6923076923076923,0.6470588235294118
5086,DSL Rays 2,2019,16,Rookie,7,28,39,13,52,19,10,29,0.75,0.6551724137931034
5086,DSL Rays 2,2019,16,Rookie,8,25,33,9,42,21,5,26,0.7857142857142857,0.8076923076923077
5087,DSL D-backs 2,2019,16,Rookie,6,26,53,24,77,42,19,61,0.6883116883116883,0.6885245901639344
5087,DSL D-backs 2,2019,16,Rookie,7,26,36,28,64,30,22,52,0.5625,0.5769230769230769
5087,DSL D-backs 2,2019,16,Rookie,8,21,25,10,35,34,9,43,0.7142857142857143,0.7906976744186046
5316,AZL Padres 2,2019,16,Rookie,6,11,17,3,20,17,9,26,0.85,0.6538461538461539
5316,AZL Padres 2,2019,16,Rookie,7,21,31,12,43,28,9,37,0.7209302325581395,0.7567567567567568
5316,AZL Padres 2,2019,16,Rookie,8,21,25,11,36,22,16,38,0.6944444444444444,0.5789473684210527
5368,Amarillo Sod Poodles,2021,12,AA,5,24,21,12,33,14,7,21,0.6363636363636364,0.6666666666666666
5368,Amarillo Sod Poodles,2021,12,AA,6,29,33,8,41,17,15,32,0.8048780487804879,0.53125
5368,Amarillo Sod Poodles,2021,12,AA,7,32,39,8,47,24,12,36,0.8297872340425532,0.6666666666666666
5368,Amarillo Sod Poodles,2021,12,AA,8,5,5,1,6,4,4,8,0.8333333333333334,0.5
5370,AZL Giants Orange,2019,16,Rookie,6,11,13,9,22,10,4,14,0.5909090909090909,0.7142857142857143
5370,AZL Giants Orange,2019,16,Rookie,7,22,55,15,70,27,14,41,0.7857142857142857,0.6585365853658537
5370,AZL Giants Orange,2019,16,Rookie,8,23,52,18,70,13,14,27,0.7428571428571429,0.48148148148148145
5372,GCL Phillies West,2019,16,Rookie,6,5,4,2,6,5,2,7,0.6666666666666666,0.7142857142857143
5372,GCL Phillies West,2019,16,Rookie,7,21,20,16,36,24,12,36,0.5555555555555556,0.6666666666666666
5372,GCL Phillies West,2019,16,Rookie,8,37,30,9,39,27,10,37,0.7692307692307693,0.7297297297297297
5374,AZL Indians Blue,2019,16,Rookie,6,11,8,3,11,17,2,19,0.7272727272727273,0.8947368421052632
5374,AZL Indians Blue,2019,16,Rookie,7,21,27,16,43,25,14,39,0.627906976744186,0.6410256410256411
5374,AZL Indians Blue,2019,16,Rookie,8,21,28,4,32,36,8,44,0.875,0.8181818181818182
5426,AZL Athletics Gold,2019,16,Rookie,6,11,6,7,13,10,2,12,0.46153846153846156,0.8333333333333334
5426,AZL Athletics Gold,2019,16,Rookie,7,21,22,6,28,32,16,48,0.7857142857142857,0.6666666666666666
5426,AZL Athletics Gold,2019,16,Rookie,8,23,26,13,39,29,11,40,0.6666666666666666,0.725
5427,AZL Dodgers Lasorda,2019,16,Rookie,6,11,11,6,17,11,4,15,0.6470588235294118,0.7333333333333333
5427,AZL Dodgers Lasorda,2019,16,Rookie,7,21,11,8,19,33,9,42,0.5789473684210527,0.7857142857142857
5427,AZL Dodgers Lasorda,2019,16,Rookie,8,21,13,9,22,25,10,35,0.5909090909090909,0.7142857142857143
5430,AZL Brewers Blue,2019,16,Rookie,6,11,25,12,37,6,8,14,0.6756756756756757,0.42857142857142855
5430,AZL Brewers Blue,2019,16,Rookie,7,21,53,17,70,31,12,43,0.7571428571428571,0.7209302325581395
5430,AZL Brewers Blue,2019,16,Rookie,8,21,37,13,50,27,11,38,0.74,0.7105263157894737
5434,Sugar Land Skeeters,2021,11,AAA,5,31,22,11,33,26,7,33,0.6666666666666666,0.7878787878787878
5434,Sugar Land Skeeters,2021,11,AAA,6,28,16,5,21,19,4,23,0.7619047619047619,0.8260869565217391
5434,Sugar Land Skeeters,2021,11,AAA,7,33,24,4,28,16,2,18,0.8571428571428571,0.8888888888888888
5434,Sugar Land Skeeters,2021,11,AAA,8,30,23,6,29,10,6,16,0.7931034482758621,0.625
5434,Sugar Land Skeeters,2021,11,AAA,9,25,15,6,21,10,3,13,0.7142857142857143,0.7692307692307693
5434,Sugar Land Skeeters,2021,11,AAA,10,3,1,1,2,0,1,1,0.5,0.0
