team_id,team_name,season,level_id,level_name,month,games,sb,cs,attempts,sb_allowed,cs_allowed,attempts_allowed,success_rate,success_rate_allowed
102,Round Rock Express,2022,11,AAA,4,23,17,9,26,28,5,33,0.6538461538461539,0.8484848484848485
102,Round Rock Express,2022,11,AAA,5,26,37,7,44,33,7,40,0.8409090909090909,0.825
102,Round Rock Express,2022,11,AAA,6,3,1,1,2,5,1,6,0.5,0.8333333333333334
103,Lake Elsinore Storm,2021,14,A,5,24,40,7,47,40,11,51,0.851063829787234,0.7843137254901961
103,Lake Elsinore Storm,2021,14,A,6,18,37,10,47,25,7,32,0.7872340425531915,0.78125
103,Lake Elsinore Storm,2021,14,A,7,27,37,12,49,34,12,46,0.7551020408163265,0.7391304347826086
103,Lake Elsinore Storm,2021,14,A,8,27,32,11,43,19,16,35,0.7441860465116279,0.5428571428571428
103,Lake Elsinore Storm,2021,14,A,9,19,19,10,29,17,11,28,0.6551724137931034,0.6071428571428571
105,Sacramento River Cats,2022,11,AAA,4,23,24,5,29,15,9,24,0.8275862068965517,0.625
105,Sacramento River Cats,2022,11,AAA,5,26,18,6,24,27,4,31,0.75,0.8709677419354839
105,Sacramento River Cats,2022,11,AAA,6,3,2,1,3,1,0,1,0.6666666666666666,1.0
106,Erie SeaWolves,2021,12,AA,8,25,12,4,16,11,6,17,0.75,0.6470588235294118
106,Erie SeaWolves,2021,12,AA,9,17,8,3,11,8,3,11,0.7272727272727273,0.7272727272727273
233,Charleston RiverDogs,2021,14,A,5,24,27,8,35,30,6,36,0.7714285714285715,0.8333333333333334
233,Charleston RiverDogs,2021,14,A,6,18,35,4,39,19,7,26,0.8974358974358975,0.7307692307692307
233,Charleston RiverDogs,2021,14,A,7,32,53,17,70,37,8,45,0.7571428571428571,0.8222222222222222
233,Charleston RiverDogs,2021,14,A,8,32,39,6,45,26,10,36,0.8666666666666667,0.7222222222222222
233,Charleston RiverDogs,2021,14,A,9,25,15,7,22,10,18,28,0.6818181818181818,0.35714285714285715
234,Durham Bulls,2022,11,AAA,4,23,20,10,30,26,1,27,0.6666666666666666,0.9629629629629629
234,Durham Bulls,2022,11,AAA,5,32,29,14,43,30,13,43,0.6744186046511628,0.6976744186046512
234,Durham Bulls,2022,11,AAA,6,3,1,0,1,6,0,6,1.0,1.0
235,Memphis Redbirds,2022,11,AAA,4,23,18,2,20,22,10,32,0.9,0.6875
235,Memphis Redbirds,2022,11,AAA,5,32,43,11,54,35,4,39,0.7962962962962963,0.8974358974358975
235,Memphis Redbirds,2022,11,AAA,6,3,6,0,6,2,1,3,1.0,0.6666666666666666
237,Midland RockHounds,2021,12,AA,8,23,9,4,13,19,11,30,0.6923076923076923,0.6333333333333333
237,Midland RockHounds,2021,12,AA,9,20,4,6,10,6,5,11,0.4,0.5454545454545454
238,Oklahoma City Dodgers,2022,11,AAA,4,23,14,9,23,20,11,31,0.6086956521739131,0.6451612903225806
238,Oklahoma City Dodgers,2022,11,AAA,5,32,17,3,20,30,7,37,0.85,0.8108108108108109
238,Oklahoma City Dodgers,2022,11,AAA,6,3,5,1,6,1,1,2,0.8333333333333334,0.5
247,Birmingham Barons,2021,12,AA,8,38,37,3,40,35,11,46,0.925,0.7608695652173914
247,Birmingham Barons,2021,12,AA,9,27,9,4,13,9,10,19,0.6923076923076923,0.47368421052631576
249,Carolina Mudcats,2021,14,A,5,30,57,4,61,47,6,53,0.9344262295081968,0.8867924528301887
249,Carolina Mudcats,2021,14,A,6,32,71,10,81,96,18,114,0.8765432098765432,0.8421052631578947
249,Carolina Mudcats,2021,14,A,7,33,44,12,56,60,16,76,0.7857142857142857,0.7894736842105263
249,Carolina Mudcats,2021,14,A,8,29,46,12,58,84,11,95,0.7931034482758621,0.8842105263157894
249,Carolina Mudcats,2021,14,A,9,20,10,3,13,50,11,61,0.7692307692307693,0.819672131147541
259,Fresno Grizzlies,2021,14,A,5,24,34,16,50,13,6,19,0.68,0.6842105263157895
259,Fresno Grizzlies,2021,14,A,6,18,40,8,48,13,6,19,0.8333333333333334,0.6842105263157895
259,Fresno Grizzlies,2021,14,A,7,30,61,24,85,20,19,39,0.7176470588235294,0.5128205128205128
259,Fresno Grizzlies,2021,14,A,8,26,53,17,70,19,8,27,0.7571428571428571,0.7037037037037037
259,Fresno Grizzlies,2021,14,A,9,20,23,13,36,7,5,12,0.6388888888888888,0.5833333333333334
260,Tulsa Drillers,2021,12,AA,8,23,4,6,10,22,4,26,0.4,0.8461538461538461
260,Tulsa Drillers,2021,12,AA,9,17,9,1,10,18,2,20,0.9,0.9
279,Palm Beach Cardinals,2021,14,A,5,27,17,7,24,31,10,41,0.7083333333333334,0.7560975609756098
279,Palm Beach Cardinals,2021,14,A,6,25,11,11,22,43,25,68,0.5,0.6323529411764706
279,Palm Beach Cardinals,2021,14,A,7,60,18,11,29,44,37,81,0.6206896551724138,0.5432098765432098
279,Palm Beach Cardinals,2021,14,A,8,45,10,14,24,32,5,37,0.4166666666666667,0.8648648648648649
279,Palm Beach Cardinals,2021,14,A,9,26,10,7,17,36,22,58,0.5882352941176471,0.6206896551724138
342,Albuquerque Isotopes,2022,11,AAA,4,23,14,4,18,17,7,24,0.7777777777777778,0.7083333333333334
342,Albuquerque Isotopes,2022,11,AAA,5,29,27,4,31,27,11,38,0.8709677419354839,0.7105263157894737
342,Albuquerque Isotopes,2022,11,AAA,6,3,5,1,6,3,2,5,0.8333333333333334,0.6
400,Las Vegas Aviators,2022,11,AAA,4,26,15,3,18,19,12,31,0.8333333333333334,0.6129032258064516
400,Las Vegas Aviators,2022,11,AAA,5,27,23,6,29,26,6,32,0.7931034482758621,0.8125
400,Las Vegas Aviators,2022,11,AAA,6,3,1,0,1,2,1,3,1.0,0.6666666666666666
401,Inland Empire 66ers,2021,14,A,5,25,34,10,44,16,14,30,0.7727272727272727,0.5333333333333333
401,Inland Empire 66ers,2021,14,A,6,18,21,7,28,17,5,22,0.75,0.7727272727272727
401,Inland Empire 66ers,2021,14,A,7,27,35,8,43,43,8,51,0.813953488372093,0.8431372549019608
401,Inland Empire 66ers,2021,14,A,8,28,36,13,49,25,9,34,0.7346938775510204,0.7352941176470589
401,Inland Empire 66ers,2021,14,A,9,17,24,7,31,17,6,23,0.7741935483870968,0.7391304347826086
402,Akron RubberDucks,2021,12,AA,8,27,20,12,32,27,7,34,0.625,0.7941176470588235
402,Akron RubberDucks,2021,12,AA,9,17,15,5,20,18,6,24,0.75,0.75
403,Everett AquaSox,2021,13,High-A,5,24,30,12,42,43,7,50,0.7142857142857143,0.86
403,Everett AquaSox,2021,13,High-A,6,30,33,7,40,52,7,59,0.825,0.8813559322033898
403,Everett AquaSox,2021,13,High-A,7,29,41,12,53,33,7,40,0.7735849056603774,0.825
403,Everett AquaSox,2021,13,High-A,8,30,26,6,32,27,8,35,0.8125,0.7714285714285715
403,Everett AquaSox,2021,13,High-A,9,16,16,5,21,19,2,21,0.7619047619047619,0.9047619047619048
404,ACL Angels,2021,16,Rookie,6,2,1,1,2,2,3,5,0.5,0.4
404,ACL Angels,2021,16,Rookie,7,30,30,17,47,31,10,41,0.6382978723404256,0.7560975609756098
404,ACL Angels,2021,16,Rookie,8,28,35,6,41,20,9,29,0.8536585365853658,0.6896551724137931
404,ACL Angels,2021,16,Rookie,9,15,26,2,28,12,7,19,0.9285714285714286,0.631578947368421
406,ACL Brewers Gold,2021,16,Rookie,6,2,0,0,0,0,0,0,,
406,ACL Brewers Gold,2021,16,Rookie,7,25,12,2,14,23,11,34,0.8571428571428571,0.6764705882352942
406,ACL Brewers Gold,2021,16,Rookie,8,29,20,8,28,25,15,40,0.7142857142857143,0.625
406,ACL Brewers Gold,2021,16,Rookie,9,13,17,8,25,12,5,17,0.68,0.7058823529411765
407,ACL Cubs,2021,16,Rookie,6,2,3,0,3,3,1,4,1.0,0.75
407,ACL Cubs,2021,16,Rookie,7,28,32,11,43,34,12,46,0.7441860465116279,0.7391304347826086
407,ACL Cubs,2021,16,Rookie,8,26,31,11,42,40,14,54,0.7380952380952381,0.7407407407407407
407,ACL Cubs,2021,16,Rookie,9,13,13,5,18,24,3,27,0.7222222222222222,0.8888888888888888
408,ACL Giants Black,2021,16,Rookie,6,2,2,0,2,2,1,3,1.0,0.6666666666666666
408,ACL Giants Black,2021,16,Rookie,7,28,26,14,40,23,8,31,0.65,0.7419354838709677
408,ACL Giants Black,2021,16,Rookie,8,25,13,5,18,21,10,31,0.7222222222222222,0.6774193548387096
408,ACL Giants Black,2021,16,Rookie,9,16,6,2,8,11,7,18,0.75,0.6111111111111112
409,ACL Mariners,2021,16,Rookie,6,2,1,0,1,0,0,0,1.0,
409,ACL Mariners,2021,16,Rookie,7,29,60,11,71,29,25,54,0.8450704225352113,0.5370370370370371
409,ACL Mariners,2021,16,Rookie,8,22,15,10,25,13,10,23,0.6,0.5652173913043478
409,ACL Mariners,2021,16,Rookie,9,13,14,2,16,15,4,19,0.875,0.7894736842105263
410,ACL Padres,2021,16,Rookie,6,2,1,1,2,0,1,1,0.5,0.0
410,ACL Padres,2021,16,Rookie,7,31,27,31,58,39,15,54,0.46551724137931033,0.7222222222222222
410,ACL Padres,2021,16,Rookie,8,25,22,10,32,21,15,36,0.6875,0.5833333333333334
410,ACL Padres,2021,16,Rookie,9,16,12,3,15,27,9,36,0.8,0.75
411,ACL Rangers,2021,16,Rookie,6,2,1,0,1,1,1,2,1.0,0.5
411,ACL Rangers,2021,16,Rookie,7,30,51,24,75,36,14,50,0.68,0.72
411,ACL Rangers,2021,16,Rookie,8,32,41,21,62,48,13,61,0.6612903225806451,0.7868852459016393
411,ACL Rangers,2021,16,Rookie,9,16,28,13,41,23,3,26,0.6829268292682927,0.8846153846153846
412,ACL Royals Blue,2021,16,Rookie,6,2,0,2,2,2,1,3,0.0,0.6666666666666666
412,ACL Royals Blue,2021,16,Rookie,7,26,40,8,48,25,8,33,0.8333333333333334,0.7575757575757576
412,ACL Royals Blue,2021,16,Rookie,8,22,17,11,28,12,7,19,0.6071428571428571,0.631578947368421
412,ACL Royals Blue,2021,16,Rookie,9,13,15,4,19,9,5,14,0.7894736842105263,0.6428571428571429
414,Salem Red Sox,2021,14,A,5,33,42,8,50,35,6,41,0.84,0.8536585365853658
414,Salem Red Sox,2021,14,A,6,18,12,7,19,15,5,20,0.631578947368421,0.75
414,Salem Red Sox,2021,14,A,7,30,37,10,47,16,7,23,0.7872340425531915,0.6956521739130435
414,Salem Red Sox,2021,14,A,8,30,17,13,30,20,7,27,0.5666666666666667,0.7407407407407407
414,Salem Red Sox,2021,14,A,9,22,11,5,16,21,9,30,0.6875,0.7
416,Louisville Bats,2022,11,AAA,4,26,22,6,28,28,4,32,0.7857142857142857,0.875
416,Louisville Bats,2022,11,AAA,5,36,17,12,29,46,19,65,0.5862068965517241,0.7076923076923077
416,Louisville Bats,2022,11,AAA,6,4,6,1,7,4,1,5,0.8571428571428571,0.8
418,Bowie Baysox,2021,12,AA,8,28,23,8,31,13,4,17,0.7419354838709677,0.7647058823529411
418,Bowie Baysox,2021,12,AA,9,24,17,3,20,17,9,26,0.85,0.6538461538461539
419,Hillsboro Hops,2021,13,High-A,5,24,68,12,80,26,12,38,0.85,0.6842105263157895
419,Hillsboro Hops,2021,13,High-A,6,33,77,17,94,37,10,47,0.8191489361702128,0.7872340425531915
419,Hillsboro Hops,2021,13,High-A,7,29,40,19,59,31,9,40,0.6779661016949152,0.775
419,Hillsboro Hops,2021,13,High-A,8,29,29,10,39,18,10,28,0.7435897435897436,0.6428571428571429
419,Hillsboro Hops,2021,13,High-A,9,20,32,10,42,4,5,9,0.7619047619047619,0.4444444444444444
421,Montgomery Biscuits,2021,12,AA,8,33,41,5,46,39,6,45,0.8913043478260869,0.8666666666666667
421,Montgomery Biscuits,2021,12,AA,9,23,16,12,28,9,4,13,0.5714285714285714,0.6923076923076923
422,Buffalo Bisons,2022,11,AAA,4,35,51,6,57,16,15,31,0.8947368421052632,0.5161290322580645
422,Buffalo Bisons,2022,11,AAA,5,39,71,7,78,22,16,38,0.9102564102564102,0.5789473684210527
422,Buffalo Bisons,2022,11,AAA,6,7,9,0,9,2,2,4,1.0,0.5
424,Dunedin Blue Jays,2021,14,A,5,24,33,6,39,40,6,46,0.8461538461538461,0.8695652173913043
424,Dunedin Blue Jays,2021,14,A,6,31,20,11,31,25,1,26,0.6451612903225806,0.9615384615384616
424,Dunedin Blue Jays,2021,14,A,7,33,106,16,122,38,3,41,0.8688524590163934,0.926829268292683
424,Dunedin Blue Jays,2021,14,A,8,42,84,18,102,59,7,66,0.8235294117647058,0.8939393939393939
424,Dunedin Blue Jays,2021,14,A,9,26,51,22,73,47,8,55,0.6986301369863014,0.8545454545454545
426,Wilmington Blue Rocks,2021,13,High-A,5,24,18,13,31,18,15,33,0.5806451612903226,0.5454545454545454
426,Wilmington Blue Rocks,2021,13,High-A,6,38,49,9,58,25,7,32,0.8448275862068966,0.78125
426,Wilmington Blue Rocks,2021,13,High-A,7,35,44,15,59,31,9,40,0.7457627118644068,0.775
426,Wilmington Blue Rocks,2021,13,High-A,8,32,29,12,41,16,5,21,0.7073170731707317,0.7619047619047619
426,Wilmington Blue Rocks,2021,13,High-A,9,17,5,3,8,6,3,9,0.625,0.6666666666666666
427,Jersey Shore BlueClaws,2021,13,High-A,5,28,23,10,33,43,6,49,0.696969696969697,0.8775510204081632
427,Jersey Shore BlueClaws,2021,13,High-A,6,39,64,7,71,41,8,49,0.9014084507042254,0.8367346938775511
427,Jersey Shore BlueClaws,2021,13,High-A,7,41,20,15,35,13,22,35,0.5714285714285714,0.37142857142857144
427,Jersey Shore BlueClaws,2021,13,High-A,8,35,16,2,18,40,16,56,0.8888888888888888,0.7142857142857143
427,Jersey Shore BlueClaws,2021,13,High-A,9,20,24,7,31,14,4,18,0.7741935483870968,0.7777777777777778
428,Greenville Drive,2021,13,High-A,5,27,14,8,22,21,8,29,0.6363636363636364,0.7241379310344828
428,Greenville Drive,2021,13,High-A,6,26,21,9,30,32,6,38,0.7,0.8421052631578947
428,Greenville Drive,2021,13,High-A,7,35,18,6,24,23,4,27,0.75,0.8518518518518519
428,Greenville Drive,2021,13,High-A,8,35,18,8,26,31,8,39,0.6923076923076923,0.7948717948717948
428,Greenville Drive,2021,13,High-A,9,17,5,2,7,9,5,14,0.7142857142857143,0.6428571428571429
430,Mississippi Braves,2021,12,AA,8,29,30,4,34,21,3,24,0.8823529411764706,0.875
430,Mississippi Braves,2021,12,AA,9,17,9,4,13,14,5,19,0.6923076923076923,0.7368421052631579
431,Gwinnett Stripers,2022,11,AAA,4,23,22,7,29,31,4,35,0.7586206896551724,0.8857142857142857
431,Gwinnett Stripers,2022,11,AAA,5,29,16,4,20,31,3,34,0.8,0.9117647058823529
431,Gwinnett Stripers,2022,11,AAA,6,4,4,1,5,6,1,7,0.8,0.8571428571428571
432,Rome Braves,2021,13,High-A,5,27,35,9,44,42,6,48,0.7954545454545454,0.875
432,Rome Braves,2021,13,High-A,6,34,34,14,48,41,6,47,0.7083333333333334,0.8723404255319149
432,Rome Braves,2021,13,High-A,7,34,48,11,59,57,12,69,0.8135593220338984,0.8260869565217391
432,Rome Braves,2021,13,High-A,8,39,29,16,45,32,18,50,0.6444444444444445,0.64
432,Rome Braves,2021,13,High-A,9,19,10,7,17,8,8,16,0.5882352941176471,0.5
435,Vancouver Canadians,2021,13,High-A,5,24,38,18,56,46,15,61,0.6785714285714286,0.7540983606557377
435,Vancouver Canadians,2021,13,High-A,6,26,46,9,55,40,9,49,0.8363636363636363,0.8163265306122449
435,Vancouver Canadians,2021,13,High-A,7,27,18,8,26,49,15,64,0.6923076923076923,0.765625
435,Vancouver Canadians,2021,13,High-A,8,26,14,7,21,34,7,41,0.6666666666666666,0.8292682926829268
435,Vancouver Canadians,2021,13,High-A,9,17,10,4,14,28,11,39,0.7142857142857143,0.717948717948718
436,Fredericksburg Nationals,2021,14,A,5,24,16,6,22,34,8,42,0.7272727272727273,0.8095238095238095
436,Fredericksburg Nationals,2021,14,A,6,18,26,4,30,18,5,23,0.8666666666666667,0.782608695652174
436,Fredericksburg Nationals,2021,14,A,7,33,11,15,26,28,13,41,0.4230769230769231,0.6829268292682927
436,Fredericksburg Nationals,2021,14,A,8,30,35,8,43,26,14,40,0.813953488372093,0.65
436,Fredericksburg Nationals,2021,14,A,9,25,36,11,47,18,4,22,0.7659574468085106,0.8181818181818182
437,Lake County Captains,2021,13,High-A,5,24,44,8,52,27,7,34,0.8461538461538461,0.7941176470588235
437,Lake County Captains,2021,13,High-A,6,34,36,20,56,42,14,56,0.6428571428571429,0.75
437,Lake County Captains,2021,13,High-A,7,31,35,23,58,21,11,32,0.603448275862069,0.65625
437,Lake County Captains,2021,13,High-A,8,34,31,16,47,33,4,37,0.6595744680851063,0.8918918918918919
437,Lake County Captains,2021,13,High-A,9,17,14,8,22,16,5,21,0.6363636363636364,0.7619047619047619
440,Springfield Cardinals,2021,12,AA,8,26,11,12,23,16,13,29,0.4782608695652174,0.5517241379310345
440,Springfield Cardinals,2021,12,AA,9,17,11,2,13,8,6,14,0.8461538461538461,0.5714285714285714
443,Peoria Chiefs,2021,13,High-A,5,33,24,19,43,69,7,76,0.5581395348837209,0.9078947368421053
443,Peoria Chiefs,2021,13,High-A,6,33,13,12,25,52,11,63,0.52,0.8253968253968254
443,Peoria Chiefs,2021,13,High-A,7,29,12,10,22,28,13,41,0.5454545454545454,0.6829268292682927
443,Peoria Chiefs,2021,13,High-A,8,35,46,10,56,18,14,32,0.8214285714285714,0.5625
443,Peoria Chiefs,2021,13,High-A,9,17,16,8,24,15,3,18,0.6666666666666666,0.8333333333333334
445,Columbus Clippers,2022,11,AAA,4,26,26,8,34,23,6,29,0.7647058823529411,0.7931034482758621
445,Columbus Clippers,2022,11,AAA,5,32,21,6,27,31,6,37,0.7777777777777778,0.8378378378378378
445,Columbus Clippers,2022,11,AAA,6,3,2,1,3,2,0,2,0.6666666666666666,1.0
448,Hickory Crawdads,2021,13,High-A,5,24,18,5,23,28,7,35,0.782608695652174,0.8
448,Hickory Crawdads,2021,13,High-A,6,37,12,11,23,33,17,50,0.5217391304347826,0.66
448,Hickory Crawdads,2021,13,High-A,7,39,19,7,26,33,13,46,0.7307692307692307,0.717391304347826
448,Hickory Crawdads,2021,13,High-A,8,41,26,12,38,36,23,59,0.6842105263157895,0.6101694915254238
448,Hickory Crawdads,2021,13,High-A,9,19,5,4,9,8,6,14,0.5555555555555556,0.5714285714285714
450,Daytona Tortugas,2021,14,A,5,33,24,8,32,27,17,44,0.75,0.6136363636363636
450,Daytona Tortugas,2021,14,A,6,30,14,12,26,8,9,17,0.5384615384615384,0.47058823529411764
450,Daytona Tortugas,2021,14,A,7,36,21,20,41,23,10,33,0.5121951219512195,0.696969696969697
450,Daytona Tortugas,2021,14,A,8,29,19,12,31,16,9,25,0.6129032258064516,0.64
450,Daytona Tortugas,2021,14,A,9,23,28,10,38,7,4,11,0.7368421052631579,0.6363636363636364
451,Iowa Cubs,2022,11,AAA,4,27,30,6,36,36,6,42,0.8333333333333334,0.8571428571428571
451,Iowa Cubs,2022,11,AAA,5,29,37,7,44,40,10,50,0.8409090909090909,0.8
451,Iowa Cubs,2022,11,AAA,6,3,4,1,5,1,0,1,0.8,1.0
452,Altoona Curve,2021,12,AA,8,27,16,11,27,20,3,23,0.5925925925925926,0.8695652173913043
452,Altoona Curve,2021,12,AA,9,19,9,3,12,12,1,13,0.75,0.9230769230769231
453,Brooklyn Cyclones,2021,13,High-A,5,29,10,10,20,22,8,30,0.5,0.7333333333333333
453,Brooklyn Cyclones,2021,13,High-A,6,34,18,6,24,50,8,58,0.75,0.8620689655172413
453,Brooklyn Cyclones,2021,13,High-A,7,33,22,13,35,38,9,47,0.6285714285714286,0.8085106382978723
453,Brooklyn Cyclones,2021,13,High-A,8,32,26,8,34,38,7,45,0.7647058823529411,0.8444444444444444
453,Brooklyn Cyclones,2021,13,High-A,9,19,15,4,19,21,4,25,0.7894736842105263,0.84
456,Great Lakes Loons,2021,13,High-A,5,24,46,11,57,34,7,41,0.8070175438596491,0.8292682926829268
456,Great Lakes Loons,2021,13,High-A,6,29,37,9,46,45,6,51,0.8043478260869565,0.8823529411764706
456,Great Lakes Loons,2021,13,High-A,7,36,20,4,24,29,12,41,0.8333333333333334,0.7073170731707317
456,Great Lakes Loons,2021,13,High-A,8,29,15,8,23,37,8,45,0.6521739130434783,0.8222222222222222
456,Great Lakes Loons,2021,13,High-A,9,17,11,1,12,9,3,12,0.9166666666666666,0.75
459,Dayton Dragons,2021,13,High-A,5,27,51,14,65,32,6,38,0.7846153846153846,0.8421052631578947
459,Dayton Dragons,2021,13,High-A,6,41,28,10,38,28,11,39,0.7368421052631579,0.717948717948718
459,Dayton Dragons,2021,13,High-A,7,33,16,11,27,31,11,42,0.5925925925925926,0.7380952380952381
459,Dayton Dragons,2021,13,High-A,8,32,41,6,47,26,13,39,0.8723404255319149,0.6666666666666666
459,Dayton Dragons,2021,13,High-A,9,22,33,10,43,11,8,19,0.7674418604651163,0.5789473684210527
460,Tri-City Dust Devils,2021,13,High-A,5,24,24,9,33,44,17,61,0.7272727272727273,0.7213114754098361
460,Tri-City Dust Devils,2021,13,High-A,6,30,30,5,35,58,12,70,0.8571428571428571,0.8285714285714286
460,Tri-City Dust Devils,2021,13,High-A,7,29,34,6,40,38,17,55,0.85,0.6909090909090909
460,Tri-City Dust Devils,2021,13,High-A,8,26,20,4,24,23,11,34,0.8333333333333334,0.6764705882352942
460,Tri-City Dust Devils,2021,13,High-A,9,17,6,2,8,11,6,17,0.75,0.6470588235294118
461,Eugene Emeralds,2021,13,High-A,5,24,26,7,33,52,16,68,0.7878787878787878,0.7647058823529411
461,Eugene Emeralds,2021,13,High-A,6,27,42,13,55,63,14,77,0.7636363636363637,0.8181818181818182
461,Eugene Emeralds,2021,13,High-A,7,29,27,10,37,44,13,57,0.7297297297297297,0.7719298245614035
461,Eugene Emeralds,2021,13,High-A,8,27,19,4,23,21,5,26,0.8260869565217391,0.8076923076923077
461,Eugene Emeralds,2021,13,High-A,9,19,14,6,20,27,8,35,0.7,0.7714285714285715
463,New Hampshire Fisher Cats,2021,12,AA,8,26,38,10,48,21,4,25,0.7916666666666666,0.84
463,New Hampshire Fisher Cats,2021,12,AA,9,24,10,3,13,2,6,8,0.7692307692307693,0.25
464,FCL Braves,2021,16,Rookie,6,3,7,0,7,8,0,8,1.0,1.0
464,FCL Braves,2021,16,Rookie,7,41,90,20,110,81,23,104,0.8181818181818182,0.7788461538461539
464,FCL Braves,2021,16,Rookie,8,49,99,39,138,89,23,112,0.717391304347826,0.7946428571428571
464,FCL Braves,2021,16,Rookie,9,20,24,9,33,48,13,61,0.7272727272727273,0.7868852459016393
466,FCL Nationals,2021,16,Rookie,6,2,3,2,5,0,0,0,0.6,
466,FCL Nationals,2021,16,Rookie,7,34,29,12,41,46,10,56,0.7073170731707317,0.8214285714285714
466,FCL Nationals,2021,16,Rookie,8,36,29,14,43,38,18,56,0.6744186046511628,0.6785714285714286
466,FCL Nationals,2021,16,Rookie,9,21,11,12,23,35,16,51,0.4782608695652174,0.6862745098039216
467,FCL Marlins,2021,16,Rookie,6,3,5,4,9,2,2,4,0.5555555555555556,0.5
467,FCL Marlins,2021,16,Rookie,7,32,27,16,43,31,21,52,0.627906976744186,0.5961538461538461
467,FCL Marlins,2021,16,Rookie,8,38,32,10,42,36,29,65,0.7619047619047619,0.5538461538461539
467,FCL Marlins,2021,16,Rookie,9,21,23,8,31,29,12,41,0.7419354838709677,0.7073170731707317
468,FCL Mets,2021,16,Rookie,6,3,5,1,6,10,0,10,0.8333333333333334,1.0
468,FCL Mets,2021,16,Rookie,7,27,25,7,32,15,9,24,0.78125,0.625
468,FCL Mets,2021,16,Rookie,8,30,23,11,34,24,10,34,0.6764705882352942,0.7058823529411765
468,FCL Mets,2021,16,Rookie,9,21,27,10,37,17,7,24,0.7297297297297297,0.7083333333333334
469,FCL Phillies,2021,16,Rookie,6,3,4,0,4,1,1,2,1.0,0.5
469,FCL Phillies,2021,16,Rookie,7,31,31,8,39,30,8,38,0.7948717948717948,0.7894736842105263
469,FCL Phillies,2021,16,Rookie,8,23,37,15,52,24,6,30,0.7115384615384616,0.8
469,FCL Phillies,2021,16,Rookie,9,24,21,3,24,19,4,23,0.875,0.8260869565217391
470,FCL Pirates Black,2021,16,Rookie,6,2,1,1,2,0,1,1,0.5,0.0
470,FCL Pirates Black,2021,16,Rookie,7,37,43,10,53,47,8,55,0.8113207547169812,0.8545454545454545
470,FCL Pirates Black,2021,16,Rookie,8,32,24,11,35,42,6,48,0.6857142857142857,0.875
470,FCL Pirates Black,2021,16,Rookie,9,16,5,2,7,24,17,41,0.7142857142857143,0.5853658536585366
471,FCL Red Sox,2021,16,Rookie,6,3,8,0,8,7,0,7,1.0,1.0
471,FCL Red Sox,2021,16,Rookie,7,32,23,8,31,26,12,38,0.7419354838709677,0.6842105263157895
471,FCL Red Sox,2021,16,Rookie,8,44,30,10,40,49,21,70,0.75,0.7
471,FCL Red Sox,2021,16,Rookie,9,34,33,4,37,70,9,79,0.8918918918918919,0.8860759493670886
473,FCL Tigers East,2021,16,Rookie,6,2,3,4,7,9,3,12,0.42857142857142855,0.75
473,FCL Tigers East,2021,16,Rookie,7,32,16,10,26,49,10,59,0.6153846153846154,0.8305084745762712
473,FCL Tigers East,2021,16,Rookie,8,25,22,10,32,40,16,56,0.6875,0.7142857142857143
473,FCL Tigers East,2021,16,Rookie,9,15,4,4,8,9,2,11,0.5,0.8181818181818182
474,FCL Twins,2021,16,Rookie,6,2,2,1,3,0,1,1,0.6666666666666666,0.0
474,FCL Twins,2021,16,Rookie,7,31,18,10,28,31,10,41,0.6428571428571429,0.7560975609756098
474,FCL Twins,2021,16,Rookie,8,39,32,12,44,32,8,40,0.7272727272727273,0.8
474,FCL Twins,2021,16,Rookie,9,35,61,3,64,43,2,45,0.953125,0.9555555555555556
475,FCL Yankees,2021,16,Rookie,6,3,6,2,8,4,2,6,0.75,0.6666666666666666
475,FCL Yankees,2021,16,Rookie,7,36,74,11,85,35,16,51,0.8705882352941177,0.6862745098039216
475,FCL Yankees,2021,16,Rookie,8,32,49,11,60,69,14,83,0.8166666666666667,0.8313253012048193
475,FCL Yankees,2021,16,Rookie,9,21,28,7,35,15,5,20,0.8,0.75
476,San Jose Giants,2021,14,A,5,24,14,5,19,35,14,49,0.7368421052631579,0.7142857142857143
476,San Jose Giants,2021,14,A,6,18,25,7,32,14,5,19,0.78125,0.7368421052631579
476,San Jose Giants,2021,14,A,7,27,22,5,27,20,16,36,0.8148148148148148,0.5555555555555556
476,San Jose Giants,2021,14,A,8,26,13,8,21,23,9,32,0.6190476190476191,0.71875
476,San Jose Giants,2021,14,A,9,17,6,5,11,14,12,26,0.5454545454545454,0.5384615384615384
477,Greensboro Grasshoppers,2021,13,High-A,5,27,37,10,47,27,12,39,0.7872340425531915,0.6923076923076923
477,Greensboro Grasshoppers,2021,13,High-A,6,34,42,18,60,23,10,33,0.7,0.696969696969697
477,Greensboro Grasshoppers,2021,13,High-A,7,27,51,12,63,27,5,32,0.8095238095238095,0.84375
477,Greensboro Grasshoppers,2021,13,High-A,8,29,27,12,39,12,4,16,0.6923076923076923,0.75
477,Greensboro Grasshoppers,2021,13,High-A,9,20,33,9,42,24,9,33,0.7857142857142857,0.7272727272727273
478,Augusta GreenJackets,2021,14,A,5,30,34,8,42,44,10,54,0.8095238095238095,0.8148148148148148
478,Augusta GreenJackets,2021,14,A,6,20,24,9,33,38,4,42,0.7272727272727273,0.9047619047619048
478,Augusta GreenJackets,2021,14,A,7,32,27,10,37,64,5,69,0.7297297297297297,0.927536231884058
478,Augusta GreenJackets,2021,14,A,8,29,34,9,43,29,4,33,0.7906976744186046,0.8787878787878788
478,Augusta GreenJackets,2021,14,A,9,20,28,11,39,18,6,24,0.717948717948718,0.75
479,Jupiter Hammerheads,2021,14,A,5,24,26,12,38,29,11,40,0.6842105263157895,0.725
479,Jupiter Hammerheads,2021,14,A,6,27,33,12,45,17,14,31,0.7333333333333333,0.5483870967741935
479,Jupiter Hammerheads,2021,14,A,7,49,43,20,63,35,15,50,0.6825396825396826,0.7
479,Jupiter Hammerheads,2021,14,A,8,36,26,9,35,29,13,42,0.7428571428571429,0.6904761904761905
479,Jupiter Hammerheads,2021,14,A,9,20,8,2,10,16,7,23,0.8,0.6956521739130435
481,Lynchburg Hillcats,2021,14,A,5,25,40,9,49,26,7,33,0.8163265306122449,0.7878787878787878
481,Lynchburg Hillcats,2021,14,A,6,21,20,7,27,9,5,14,0.7407407407407407,0.6428571428571429
481,Lynchburg Hillcats,2021,14,A,7,33,43,13,56,30,19,49,0.7678571428571429,0.6122448979591837
481,Lynchburg Hillcats,2021,14,A,8,28,21,11,32,15,15,30,0.65625,0.5
481,Lynchburg Hillcats,2021,14,A,9,20,6,3,9,21,5,26,0.6666666666666666,0.8076923076923077
482,Corpus Christi Hooks,2021,12,AA,8,23,11,9,20,21,5,26,0.55,0.8076923076923077
482,Corpus Christi Hooks,2021,12,AA,9,20,12,9,21,5,6,11,0.5714285714285714,0.45454545454545453
484,Indianapolis Indians,2022,11,AAA,4,27,43,5,48,26,4,30,0.8958333333333334,0.8666666666666667
484,Indianapolis Indians,2022,11,AAA,5,35,51,21,72,29,8,37,0.7083333333333334,0.7837837837837838
484,Indianapolis Indians,2022,11,AAA,6,3,1,0,1,1,0,1,1.0,1.0
485,Down East Wood Ducks,2021,14,A,5,27,46,6,52,22,6,28,0.8846153846153846,0.7857142857142857
485,Down East Wood Ducks,2021,14,A,6,28,65,14,79,51,10,61,0.8227848101265823,0.8360655737704918
485,Down East Wood Ducks,2021,14,A,7,36,76,25,101,61,18,79,0.7524752475247525,0.7721518987341772
485,Down East Wood Ducks,2021,14,A,8,32,96,11,107,54,11,65,0.897196261682243,0.8307692307692308
485,Down East Wood Ducks,2021,14,A,9,23,48,17,65,15,2,17,0.7384615384615385,0.8823529411764706
486,Spokane Indians,2021,13,High-A,5,24,49,18,67,24,9,33,0.7313432835820896,0.7272727272727273
486,Spokane Indians,2021,13,High-A,6,26,49,12,61,27,11,38,0.8032786885245902,0.7105263157894737
486,Spokane Indians,2021,13,High-A,7,27,50,14,64,15,8,23,0.78125,0.6521739130434783
486,Spokane Indians,2021,13,High-A,8,32,36,15,51,21,5,26,0.7058823529411765,0.8076923076923077
486,Spokane Indians,2021,13,High-A,9,17,21,8,29,10,3,13,0.7241379310344828,0.7692307692307693
487,Kannapolis Cannon Ballers,2021,14,A,5,27,19,5,24,54,11,65,0.7916666666666666,0.8307692307692308
487,Kannapolis Cannon Ballers,2021,14,A,6,21,26,2,28,20,9,29,0.9285714285714286,0.6896551724137931
487,Kannapolis Cannon Ballers,2021,14,A,7,35,29,13,42,17,15,32,0.6904761904761905,0.53125
487,Kannapolis Cannon Ballers,2021,14,A,8,29,22,5,27,50,14,64,0.8148148148148148,0.78125
487,Kannapolis Cannon Ballers,2021,14,A,9,23,23,11,34,27,12,39,0.6764705882352942,0.6923076923076923
488,Aberdeen IronBirds,2021,13,High-A,5,29,40,13,53,15,13,28,0.7547169811320755,0.5357142857142857
488,Aberdeen IronBirds,2021,13,High-A,6,31,33,3,36,21,15,36,0.9166666666666666,0.5833333333333334
488,Aberdeen IronBirds,2021,13,High-A,7,30,28,4,32,31,10,41,0.875,0.7560975609756098
488,Aberdeen IronBirds,2021,13,High-A,8,37,38,13,51,23,16,39,0.7450980392156863,0.5897435897435898
488,Aberdeen IronBirds,2021,13,High-A,9,20,12,5,17,8,6,14,0.7058823529411765,0.5714285714285714
492,Cedar Rapids Kernels,2021,13,High-A,5,30,36,2,38,41,5,46,0.9473684210526315,0.8913043478260869
492,Cedar Rapids Kernels,2021,13,High-A,6,29,25,7,32,42,10,52,0.78125,0.8076923076923077
492,Cedar Rapids Kernels,2021,13,High-A,7,27,22,12,34,28,1,29,0.6470588235294118,0.9655172413793104
492,Cedar Rapids Kernels,2021,13,High-A,8,29,22,13,35,24,5,29,0.6285714285714286,0.8275862068965517
492,Cedar Rapids Kernels,2021,13,High-A,9,17,14,3,17,17,6,23,0.8235294117647058,0.7391304347826086
494,Charlotte Knights,2022,11,AAA,4,23,13,8,21,11,4,15,0.6190476190476191,0.7333333333333333
494,Charlotte Knights,2022,11,AAA,5,26,21,9,30,21,6,27,0.7,0.7777777777777778
494,Charlotte Knights,2022,11,AAA,6,3,2,1,3,6,0,6,0.6666666666666666,1.0
498,Chattanooga Lookouts,2021,12,AA,8,29,12,8,20,18,1,19,0.6,0.9473684210526315
498,Chattanooga Lookouts,2021,12,AA,9,21,9,8,17,7,5,12,0.5294117647058824,0.5833333333333334
499,Lansing Lugnuts,2021,13,High-A,5,24,31,7,38,32,14,46,0.8157894736842105,0.6956521739130435
499,Lansing Lugnuts,2021,13,High-A,6,29,49,5,54,27,8,35,0.9074074074074074,0.7714285714285715
499,Lansing Lugnuts,2021,13,High-A,7,30,38,8,46,23,13,36,0.8260869565217391,0.6388888888888888
499,Lansing Lugnuts,2021,13,High-A,8,30,30,5,35,22,9,31,0.8571428571428571,0.7096774193548387
499,Lansing Lugnuts,2021,13,High-A,9,28,33,5,38,24,6,30,0.868421052631579,0.8
505,Binghamton Rumble Ponies,2021,12,AA,8,26,15,7,22,16,7,23,0.6818181818181818,0.6956521739130435
505,Binghamton Rumble Ponies,2021,12,AA,9,19,5,3,8,0,0,0,0.625,
507,St. Lucie Mets,2021,14,A,5,30,46,15,61,27,5,32,0.7540983606557377,0.84375
507,St. Lucie Mets,2021,14,A,6,30,41,5,46,17,7,24,0.8913043478260869,0.7083333333333334
507,St. Lucie Mets,2021,14,A,7,35,40,12,52,27,22,49,0.7692307692307693,0.5510204081632653
507,St. Lucie Mets,2021,14,A,8,45,35,5,40,18,12,30,0.875,0.6
507,St. Lucie Mets,2021,14,A,9,28,12,5,17,10,3,13,0.7058823529411765,0.7692307692307693
509,Fort Myers Mighty Mussels,2021,14,A,5,24,33,4,37,48,6,54,0.8918918918918919,0.8888888888888888
509,Fort Myers Mighty Mussels,2021,14,A,6,19,31,8,39,25,2,27,0.7948717948717948,0.9259259259259259
509,Fort Myers Mighty Mussels,2021,14,A,7,35,49,12,61,33,13,46,0.8032786885245902,0.717391304347826
509,Fort Myers Mighty Mussels,2021,14,A,8,43,81,14,95,74,10,84,0.8526315789473684,0.8809523809523809
509,Fort Myers Mighty Mussels,2021,14,A,9,34,34,12,46,19,7,26,0.7391304347826086,0.7307692307692307
510,San Antonio Missions,2021,12,AA,8,23,21,11,32,9,9,18,0.65625,0.5
510,San Antonio Missions,2021,12,AA,9,19,18,5,23,22,11,33,0.782608695652174,0.6666666666666666
512,Toledo Mud Hens,2022,11,AAA,4,29,28,9,37,25,2,27,0.7567567567567568,0.9259259259259259
512,Toledo Mud Hens,2022,11,AAA,5,32,24,8,32,28,10,38,0.75,0.7368421052631579
512,Toledo Mud Hens,2022,11,AAA,6,3,2,0,2,2,1,3,1.0,0.6666666666666666
515,Modesto Nuts,2021,14,A,5,24,33,11,44,39,5,44,0.75,0.8863636363636364
515,Modesto Nuts,2021,14,A,6,18,21,10,31,42,10,52,0.6774193548387096,0.8076923076923077
515,Modesto Nuts,2021,14,A,7,27,29,10,39,26,6,32,0.7435897435897436,0.8125
515,Modesto Nuts,2021,14,A,8,29,37,16,53,46,10,56,0.6981132075471698,0.8214285714285714
515,Modesto Nuts,2021,14,A,9,20,10,5,15,28,2,30,0.6666666666666666,0.9333333333333333
516,Visalia Rawhide,2021,14,A,5,24,39,10,49,38,13,51,0.7959183673469388,0.7450980392156863
516,Visalia Rawhide,2021,14,A,6,18,15,6,21,30,12,42,0.7142857142857143,0.7142857142857143
516,Visalia Rawhide,2021,14,A,7,27,40,8,48,30,7,37,0.8333333333333334,0.8108108108108109
516,Visalia Rawhide,2021,14,A,8,26,38,9,47,38,17,55,0.8085106382978723,0.6909090909090909
516,Visalia Rawhide,2021,14,A,9,17,29,11,40,14,6,20,0.725,0.7
521,Myrtle Beach Pelicans,2021,14,A,5,30,18,7,25,25,8,33,0.72,0.7575757575757576
521,Myrtle Beach Pelicans,2021,14,A,6,26,17,8,25,58,8,66,0.68,0.8787878787878788
521,Myrtle Beach Pelicans,2021,14,A,7,29,22,1,23,34,17,51,0.9565217391304348,0.6666666666666666
521,Myrtle Beach Pelicans,2021,14,A,8,29,16,4,20,49,9,58,0.8,0.8448275862068966
521,Myrtle Beach Pelicans,2021,14,A,9,25,7,16,23,13,15,28,0.30434782608695654,0.4642857142857143
522,Reading Fightin Phils,2021,12,AA,8,28,9,10,19,28,14,42,0.47368421052631576,0.6666666666666666
522,Reading Fightin Phils,2021,12,AA,9,20,11,0,11,17,7,24,1.0,0.7083333333333334
524,Stockton Ports,2021,14,A,5,24,27,11,38,34,10,44,0.7105263157894737,0.7727272727272727
524,Stockton Ports,2021,14,A,6,18,13,6,19,26,8,34,0.6842105263157895,0.7647058823529411
524,Stockton Ports,2021,14,A,7,30,21,14,35,62,16,78,0.6,0.7948717948717948
524,Stockton Ports,2021,14,A,8,29,40,11,51,38,20,58,0.7843137254901961,0.6551724137931034
524,Stockton Ports,2021,14,A,9,17,20,6,26,19,13,32,0.7692307692307693,0.59375
526,Rancho Cucamonga Quakes,2021,14,A,5,25,38,7,45,44,4,48,0.8444444444444444,0.9166666666666666
526,Rancho Cucamonga Quakes,2021,14,A,6,18,12,3,15,17,4,21,0.8,0.8095238095238095
526,Rancho Cucamonga Quakes,2021,14,A,7,27,23,8,31,33,5,38,0.7419354838709677,0.868421052631579
526,Rancho Cucamonga Quakes,2021,14,A,8,29,7,8,15,48,4,52,0.4666666666666667,0.9230769230769231
526,Rancho Cucamonga Quakes,2021,14,A,9,19,11,3,14,26,5,31,0.7857142857142857,0.8387096774193549
529,Tacoma Rainiers,2022,11,AAA,4,26,43,9,52,23,6,29,0.8269230769230769,0.7931034482758621
529,Tacoma Rainiers,2022,11,AAA,5,27,32,6,38,29,5,34,0.8421052631578947,0.8529411764705882
529,Tacoma Rainiers,2022,11,AAA,6,3,4,3,7,1,1,2,0.5714285714285714,0.5
531,Scranton/Wilkes-Barre RailRiders,2022,11,AAA,4,36,27,9,36,56,4,60,0.75,0.9333333333333333
531,Scranton/Wilkes-Barre RailRiders,2022,11,AAA,5,29,34,11,45,40,5,45,0.7555555555555555,0.8888888888888888
531,Scranton/Wilkes-Barre RailRiders,2022,11,AAA,6,7,16,0,16,14,0,14,1.0,1.0
533,Worcester Red Sox,2022,11,AAA,4,32,22,11,33,28,8,36,0.6666666666666666,0.7777777777777778
533,Worcester Red Sox,2022,11,AAA,5,29,21,2,23,27,9,36,0.9130434782608695,0.75
533,Worcester Red Sox,2022,11,AAA,6,4,2,1,3,2,0,2,0.6666666666666666,1.0
534,Rochester Red Wings,2022,11,AAA,4,29,20,2,22,18,10,28,0.9090909090909091,0.6428571428571429
534,Rochester Red Wings,2022,11,AAA,5,29,43,8,51,46,9,55,0.8431372549019608,0.8363636363636363
534,Rochester Red Wings,2022,11,AAA,6,7,2,2,4,9,0,9,0.5,1.0
537,Hudson Valley Renegades,2021,13,High-A,5,28,46,11,57,42,10,52,0.8070175438596491,0.8076923076923077
537,Hudson Valley Renegades,2021,13,High-A,6,35,40,9,49,56,8,64,0.8163265306122449,0.875
537,Hudson Valley Renegades,2021,13,High-A,7,40,28,16,44,31,18,49,0.6363636363636364,0.6326530612244898
537,Hudson Valley Renegades,2021,13,High-A,8,27,27,7,34,27,8,35,0.7941176470588235,0.7714285714285715
537,Hudson Valley Renegades,2021,13,High-A,9,22,26,10,36,36,13,49,0.7222222222222222,0.7346938775510204
538,Hartford Yard Goats,2021,12,AA,8,22,19,1,20,22,12,34,0.95,0.6470588235294118
538,Hartford Yard Goats,2021,12,AA,9,23,22,8,30,26,6,32,0.7333333333333333,0.8125
540,Frisco RoughRiders,2021,12,AA,8,30,29,5,34,32,11,43,0.8529411764705882,0.7441860465116279
540,Frisco RoughRiders,2021,12,AA,9,19,22,5,27,18,7,25,0.8148148148148148,0.72
541,Omaha Storm Chasers,2022,11,AAA,4,34,36,2,38,36,2,38,0.9473684210526315,0.9473684210526315
541,Omaha Storm Chasers,2022,11,AAA,5,29,27,10,37,11,6,17,0.7297297297297297,0.6470588235294118
541,Omaha Storm Chasers,2022,11,AAA,6,3,1,0,1,1,0,1,1.0,1.0
546,Portland Sea Dogs,2021,12,AA,8,33,8,8,16,21,5,26,0.5,0.8076923076923077
546,Portland Sea Dogs,2021,12,AA,9,26,2,5,7,7,3,10,0.2857142857142857,0.7
547,Harrisburg Senators,2021,12,AA,8,22,13,8,21,20,5,25,0.6190476190476191,0.8
547,Harrisburg Senators,2021,12,AA,9,19,6,4,10,18,4,22,0.6,0.8181818181818182
548,Delmarva Shorebirds,2021,14,A,5,31,57,4,61,63,7,70,0.9344262295081968,0.9
548,Delmarva Shorebirds,2021,14,A,6,21,11,4,15,27,7,34,0.7333333333333333,0.7941176470588235
548,Delmarva Shorebirds,2021,14,A,7,33,22,12,34,69,11,80,0.6470588235294118,0.8625
548,Delmarva Shorebirds,2021,14,A,8,31,38,10,48,34,2,36,0.7916666666666666,0.9444444444444444
548,Delmarva Shorebirds,2021,14,A,9,17,42,8,50,23,6,29,0.84,0.7931034482758621
550,South Bend Cubs,2021,13,High-A,5,24,38,5,43,52,12,64,0.8837209302325582,0.8125
550,South Bend Cubs,2021,13,High-A,6,31,59,15,74,41,23,64,0.7972972972972973,0.640625
550,South Bend Cubs,2021,13,High-A,7,31,46,19,65,32,18,50,0.7076923076923077,0.64
550,South Bend Cubs,2021,13,High-A,8,38,20,14,34,51,11,62,0.5882352941176471,0.8225806451612904
550,South Bend Cubs,2021,13,High-A,9,17,11,3,14,31,7,38,0.7857142857142857,0.8157894736842105
552,Syracuse Mets,2022,11,AAA,4,33,27,12,39,20,3,23,0.6923076923076923,0.8695652173913043
552,Syracuse Mets,2022,11,AAA,5,30,21,9,30,36,8,44,0.7,0.8181818181818182
552,Syracuse Mets,2022,11,AAA,6,4,2,0,2,2,1,3,1.0,0.6666666666666666
553,Tennessee Smokies,2021,12,AA,8,34,28,6,34,40,5,45,0.8235294117647058,0.8888888888888888
553,Tennessee Smokies,2021,12,AA,9,20,9,6,15,17,5,22,0.6,0.7727272727272727
554,Beloit Snappers,2021,13,High-A,5,27,43,7,50,32,10,42,0.86,0.7619047619047619
554,Beloit Snappers,2021,13,High-A,6,26,29,14,43,17,11,28,0.6744186046511628,0.6071428571428571
554,Beloit Snappers,2021,13,High-A,7,27,22,6,28,22,11,33,0.7857142857142857,0.6666666666666666
554,Beloit Snappers,2021,13,High-A,8,29,17,3,20,22,13,35,0.85,0.6285714285714286
554,Beloit Snappers,2021,13,High-A,9,17,19,4,23,15,6,21,0.8260869565217391,0.7142857142857143
556,Nashville Sounds,2022,11,AAA,4,26,28,2,30,22,8,30,0.9333333333333333,0.7333333333333333
556,Nashville Sounds,2022,11,AAA,5,29,32,7,39,14,12,26,0.8205128205128205,0.5384615384615384
556,Nashville Sounds,2022,11,AAA,6,3,6,0,6,1,0,1,1.0,1.0
559,Rocket City Trash Pandas,2021,12,AA,8,24,21,7,28,17,6,23,0.75,0.7391304347826086
559,Rocket City Trash Pandas,2021,12,AA,9,17,10,3,13,13,5,18,0.7692307692307693,0.7222222222222222
561,Salt Lake Bees,2022,11,AAA,4,29,25,12,37,23,7,30,0.6756756756756757,0.7666666666666667
561,Salt Lake Bees,2022,11,AAA,5,26,31,10,41,22,6,28,0.7560975609756098,0.7857142857142857
561,Salt Lake Bees,2022,11,AAA,6,3,2,0,2,2,0,2,1.0,1.0
564,Jacksonville Jumbo Shrimp,2022,11,AAA,4,23,19,6,25,18,4,22,0.76,0.8181818181818182
564,Jacksonville Jumbo Shrimp,2022,11,AAA,5,32,10,7,17,29,8,37,0.5882352941176471,0.7837837837837838
564,Jacksonville Jumbo Shrimp,2022,11,AAA,6,3,0,0,0,4,1,5,,0.8
565,Quad Cities River Bandits,2021,13,High-A,5,30,50,2,52,32,8,40,0.9615384615384616,0.8
565,Quad Cities River Bandits,2021,13,High-A,6,27,15,4,19,26,10,36,0.7894736842105263,0.7222222222222222
565,Quad Cities River Bandits,2021,13,High-A,7,30,22,5,27,24,13,37,0.8148148148148148,0.6486486486486487
565,Quad Cities River Bandits,2021,13,High-A,8,34,36,7,43,26,6,32,0.8372093023255814,0.8125
565,Quad Cities River Bandits,2021,13,High-A,9,17,25,1,26,12,3,15,0.9615384615384616,0.8
566,Clearwater Threshers,2021,14,A,5,24,27,7,34,30,10,40,0.7941176470588235,0.75
566,Clearwater Threshers,2021,14,A,6,26,13,5,18,10,5,15,0.7222222222222222,0.6666666666666666
566,Clearwater Threshers,2021,14,A,7,36,13,12,25,60,8,68,0.52,0.8823529411764706
566,Clearwater Threshers,2021,14,A,8,58,69,32,101,49,31,80,0.6831683168316832,0.6125
566,Clearwater Threshers,2021,14,A,9,32,23,17,40,23,14,37,0.575,0.6216216216216216
568,Norfolk Tides,2022,11,AAA,4,26,24,3,27,18,5,23,0.8888888888888888,0.782608695652174
568,Norfolk Tides,2022,11,AAA,5,29,31,7,38,27,6,33,0.8157894736842105,0.8181818181818182
568,Norfolk Tides,2022,11,AAA,6,3,4,1,5,0,0,0,0.8,
570,Lakeland Flying Tigers,2021,14,A,5,24,50,7,57,24,4,28,0.8771929824561403,0.8571428571428571
570,Lakeland Flying Tigers,2021,14,A,6,34,55,12,67,44,12,56,0.8208955223880597,0.7857142857142857
570,Lakeland Flying Tigers,2021,14,A,7,40,27,11,38,31,12,43,0.7105263157894737,0.7209302325581395
570,Lakeland Flying Tigers,2021,14,A,8,32,32,9,41,24,18,42,0.7804878048780488,0.5714285714285714
570,Lakeland Flying Tigers,2021,14,A,9,34,14,2,16,14,8,22,0.875,0.6363636363636364
572,Wisconsin Timber Rattlers,2021,13,High-A,5,30,63,13,76,39,8,47,0.8289473684210527,0.8297872340425532
572,Wisconsin Timber Rattlers,2021,13,High-A,6,33,66,17,83,28,14,42,0.7951807228915663,0.6666666666666666
572,Wisconsin Timber Rattlers,2021,13,High-A,7,30,38,14,52,25,12,37,0.7307692307692307,0.6756756756756757
572,Wisconsin Timber Rattlers,2021,13,High-A,8,34,32,13,45,25,8,33,0.7111111111111111,0.7575757575757576
572,Wisconsin Timber Rattlers,2021,13,High-A,9,17,20,4,24,18,2,20,0.8333333333333334,0.9
573,Asheville Tourists,2021,13,High-A,5,24,18,5,23,16,8,24,0.782608695652174,0.6666666666666666
573,Asheville Tourists,2021,13,High-A,6,32,39,9,48,28,13,41,0.8125,0.6829268292682927
573,Asheville Tourists,2021,13,High-A,7,35,24,13,37,26,10,36,0.6486486486486487,0.7222222222222222
573,Asheville Tourists,2021,13,High-A,8,41,30,21,51,12,10,22,0.5882352941176471,0.5454545454545454
573,Asheville Tourists,2021,13,High-A,9,17,14,10,24,15,2,17,0.5833333333333334,0.8823529411764706
574,Arkansas Travelers,2021,12,AA,8,26,18,10,28,30,8,38,0.6428571428571429,0.7894736842105263
574,Arkansas Travelers,2021,12,AA,9,20,21,7,28,24,4,28,0.75,0.8571428571428571
580,Winston-Salem Dash,2021,13,High-A,5,24,15,3,18,19,4,23,0.8333333333333334,0.8260869565217391
580,Winston-Salem Dash,2021,13,High-A,6,26,24,8,32,26,11,37,0.75,0.7027027027027027
580,Winston-Salem Dash,2021,13,High-A,7,33,26,6,32,25,13,38,0.8125,0.6578947368421053
580,Winston-Salem Dash,2021,13,High-A,8,41,29,16,45,21,15,36,0.6444444444444445,0.5833333333333334
580,Winston-Salem Dash,2021,13,High-A,9,22,12,6,18,20,9,29,0.6666666666666666,0.6896551724137931
582,West Michigan Whitecaps,2021,13,High-A,5,28,37,6,43,44,12,56,0.8604651162790697,0.7857142857142857
582,West Michigan Whitecaps,2021,13,High-A,6,36,20,11,31,14,5,19,0.6451612903225806,0.7368421052631579
582,West Michigan Whitecaps,2021,13,High-A,7,31,24,18,42,22,15,37,0.5714285714285714,0.5945945945945946
582,West Michigan Whitecaps,2021,13,High-A,8,39,25,11,36,22,15,37,0.6944444444444444,0.5945945945945946
582,West Michigan Whitecaps,2021,13,High-A,9,20,9,6,15,25,5,30,0.6,0.8333333333333334
584,Fort Wayne TinCaps,2021,13,High-A,5,25,19,8,27,48,6,54,0.7037037037037037,0.8888888888888888
584,Fort Wayne TinCaps,2021,13,High-A,6,32,41,16,57,56,17,73,0.7192982456140351,0.7671232876712328
584,Fort Wayne TinCaps,2021,13,High-A,7,29,24,12,36,34,12,46,0.6666666666666666,0.7391304347826086
584,Fort Wayne TinCaps,2021,13,High-A,8,29,20,8,28,29,8,37,0.7142857142857143,0.7837837837837838
584,Fort Wayne TinCaps,2021,13,High-A,9,20,17,4,21,29,3,32,0.8095238095238095,0.90625
587,Tampa Tarpons,2021,14,A,5,24,36,5,41,50,5,55,0.8780487804878049,0.9090909090909091
587,Tampa Tarpons,2021,14,A,6,37,40,13,53,56,12,68,0.7547169811320755,0.8235294117647058
587,Tampa Tarpons,2021,14,A,7,61,54,28,82,67,12,79,0.6585365853658537,0.8481012658227848
587,Tampa Tarpons,2021,14,A,8,52,58,29,87,71,29,100,0.6666666666666666,0.71
587,Tampa Tarpons,2021,14,A,9,34,47,4,51,44,10,54,0.9215686274509803,0.8148148148148148
599,FCL Orioles Black,2021,16,Rookie,6,2,0,1,1,2,1,3,0.0,0.6666666666666666
599,FCL Orioles Black,2021,16,Rookie,7,37,35,14,49,53,23,76,0.7142857142857143,0.6973684210526315
599,FCL Orioles Black,2021,16,Rookie,8,41,55,14,69,72,22,94,0.7971014492753623,0.7659574468085106
599,FCL Orioles Black,2021,16,Rookie,9,15,7,4,11,9,6,15,0.6363636363636364,0.6
600,DSL Angels,2021,16,Rookie,7,16,22,16,38,28,8,36,0.5789473684210527,0.7777777777777778
600,DSL Angels,2021,16,Rookie,8,29,88,28,116,38,18,56,0.7586206896551724,0.6785714285714286
600,DSL Angels,2021,16,Rookie,9,25,53,23,76,27,19,46,0.6973684210526315,0.5869565217391305
600,DSL Angels,2021,16,Rookie,10,2,8,3,11,2,0,2,0.7272727272727273,1.0
601,DSL Astros,2021,16,Rookie,7,21,46,16,62,30,19,49,0.7419354838709677,0.6122448979591837
601,DSL Astros,2021,16,Rookie,8,44,100,33,133,64,13,77,0.7518796992481203,0.8311688311688312
601,DSL Astros,2021,16,Rookie,9,38,55,23,78,56,8,64,0.7051282051282052,0.875
601,DSL Astros,2021,16,Rookie,10,2,3,2,5,1,0,1,0.6,1.0
602,DSL Athletics,2021,16,Rookie,7,23,13,17,30,57,12,69,0.43333333333333335,0.8260869565217391
602,DSL Athletics,2021,16,Rookie,8,50,72,16,88,77,28,105,0.8181818181818182,0.7333333333333333
602,DSL Athletics,2021,16,Rookie,9,39,32,19,51,56,29,85,0.6274509803921569,0.6588235294117647
602,DSL Athletics,2021,16,Rookie,10,2,0,1,1,3,3,6,0.0,0.5
604,DSL Blue Jays,2021,16,Rookie,7,17,32,12,44,34,15,49,0.7272727272727273,0.6938775510204082
604,DSL Blue Jays,2021,16,Rookie,8,32,73,23,96,38,15,53,0.7604166666666666,0.7169811320754716
604,DSL Blue Jays,2021,16,Rookie,9,26,36,10,46,31,17,48,0.782608695652174,0.6458333333333334
604,DSL Blue Jays,2021,16,Rookie,10,2,4,4,8,2,1,3,0.5,0.6666666666666666
607,DSL Brewers 1,2021,16,Rookie,7,15,16,5,21,23,5,28,0.7619047619047619,0.8214285714285714
607,DSL Brewers 1,2021,16,Rookie,8,32,37,14,51,57,27,84,0.7254901960784313,0.6785714285714286
607,DSL Brewers 1,2021,16,Rookie,9,23,41,10,51,36,19,55,0.803921568627451,0.6545454545454545
607,DSL Brewers 1,2021,16,Rookie,10,2,2,0,2,5,0,5,1.0,1.0
608,DSL Cardinals Blue,2021,16,Rookie,7,16,10,2,12,12,4,16,0.8333333333333334,0.75
608,DSL Cardinals Blue,2021,16,Rookie,8,31,18,13,31,65,23,88,0.5806451612903226,0.7386363636363636
608,DSL Cardinals Blue,2021,16,Rookie,9,23,17,10,27,27,14,41,0.6296296296296297,0.6585365853658537
608,DSL Cardinals Blue,2021,16,Rookie,10,2,0,1,1,4,2,6,0.0,0.6666666666666666
609,DSL Cubs Blue,2021,16,Rookie,7,16,35,12,47,34,12,46,0.7446808510638298,0.7391304347826086
609,DSL Cubs Blue,2021,16,Rookie,8,36,70,23,93,79,29,108,0.7526881720430108,0.7314814814814815
609,DSL Cubs Blue,2021,16,Rookie,9,27,46,14,60,48,26,74,0.7666666666666667,0.6486486486486487
609,DSL Cubs Blue,2021,16,Rookie,10,2,2,3,5,5,3,8,0.4,0.625
610,DSL D-backs 1,2021,16,Rookie,7,16,27,13,40,25,18,43,0.675,0.5813953488372093
610,DSL D-backs 1,2021,16,Rookie,8,28,40,17,57,39,30,69,0.7017543859649122,0.5652173913043478
610,DSL D-backs 1,2021,16,Rookie,9,23,31,16,47,33,18,51,0.6595744680851063,0.6470588235294118
610,DSL D-backs 1,2021,16,Rookie,10,2,3,2,5,2,3,5,0.6,0.4
611,DSL LAD Bautista,2021,16,Rookie,7,19,42,14,56,19,31,50,0.75,0.38
611,DSL LAD Bautista,2021,16,Rookie,8,45,39,17,56,73,29,102,0.6964285714285714,0.7156862745098039
611,DSL LAD Bautista,2021,16,Rookie,9,29,31,18,49,27,22,49,0.6326530612244898,0.5510204081632653
611,DSL LAD Bautista,2021,16,Rookie,10,2,1,0,1,0,0,0,1.0,
612,DSL Dodgers Shoemaker,2021,16,Rookie,7,19,29,17,46,33,14,47,0.6304347826086957,0.7021276595744681
612,DSL Dodgers Shoemaker,2021,16,Rookie,8,44,81,17,98,43,26,69,0.826530612244898,0.6231884057971014
612,DSL Dodgers Shoemaker,2021,16,Rookie,9,27,43,15,58,21,15,36,0.7413793103448276,0.5833333333333334
612,DSL Dodgers Shoemaker,2021,16,Rookie,10,2,1,0,1,2,1,3,1.0,0.6666666666666666
615,DSL Giants Orange,2021,16,Rookie,7,15,15,4,19,14,7,21,0.7894736842105263,0.6666666666666666
615,DSL Giants Orange,2021,16,Rookie,8,32,41,10,51,24,17,41,0.803921568627451,0.5853658536585366
615,DSL Giants Orange,2021,16,Rookie,9,29,42,13,55,26,13,39,0.7636363636363637,0.6666666666666666
615,DSL Giants Orange,2021,16,Rookie,10,2,2,0,2,1,2,3,1.0,0.3333333333333333
616,DSL Indians Blue,2021,16,Rookie,7,19,14,12,26,15,13,28,0.5384615384615384,0.5357142857142857
616,DSL Indians Blue,2021,16,Rookie,8,38,45,22,67,78,30,108,0.6716417910447762,0.7222222222222222
616,DSL Indians Blue,2021,16,Rookie,9,31,29,9,38,26,24,50,0.7631578947368421,0.52
616,DSL Indians Blue,2021,16,Rookie,10,2,3,0,3,0,0,0,1.0,
618,DSL Mariners,2021,16,Rookie,7,15,25,12,37,30,14,44,0.6756756756756757,0.6818181818181818
618,DSL Mariners,2021,16,Rookie,8,26,18,8,26,18,16,34,0.6923076923076923,0.5294117647058824
618,DSL Mariners,2021,16,Rookie,9,26,35,12,47,29,14,43,0.7446808510638298,0.6744186046511628
618,DSL Mariners,2021,16,Rookie,10,2,0,2,2,3,1,4,0.0,0.75
619,DSL Marlins,2021,16,Rookie,7,18,38,15,53,17,15,32,0.7169811320754716,0.53125
619,DSL Marlins,2021,16,Rookie,8,47,57,14,71,83,9,92,0.8028169014084507,0.9021739130434783
619,DSL Marlins,2021,16,Rookie,9,30,48,16,64,42,11,53,0.75,0.7924528301886793
619,DSL Marlins,2021,16,Rookie,10,2,4,1,5,4,2,6,0.8,0.6666666666666666
620,DSL Mets 1,2021,16,Rookie,7,15,22,8,30,33,12,45,0.7333333333333333,0.7333333333333333
620,DSL Mets 1,2021,16,Rookie,8,25,38,20,58,39,14,53,0.6551724137931034,0.7358490566037735
620,DSL Mets 1,2021,16,Rookie,9,21,29,11,40,28,9,37,0.725,0.7567567567567568
620,DSL Mets 1,2021,16,Rookie,10,2,2,3,5,4,1,5,0.4,0.8
621,DSL Orioles 1,2021,16,Rookie,7,15,12,5,17,20,3,23,0.7058823529411765,0.8695652173913043
621,DSL Orioles 1,2021,16,Rookie,8,26,30,17,47,58,22,80,0.6382978723404256,0.725
621,DSL Orioles 1,2021,16,Rookie,9,23,16,24,40,52,21,73,0.4,0.7123287671232876
621,DSL Orioles 1,2021,16,Rookie,10,2,2,1,3,1,2,3,0.6666666666666666,0.3333333333333333
622,DSL Padres,2021,16,Rookie,7,17,31,13,44,47,12,59,0.7045454545454546,0.7966101694915254
622,DSL Padres,2021,16,Rookie,8,34,67,33,100,68,21,89,0.67,0.7640449438202247
622,DSL Padres,2021,16,Rookie,9,29,25,39,64,57,27,84,0.390625,0.6785714285714286
622,DSL Padres,2021,16,Rookie,10,2,0,0,0,3,2,5,,0.6
623,DSL Phillies Red,2021,16,Rookie,7,16,17,8,25,24,11,35,0.68,0.6857142857142857
623,DSL Phillies Red,2021,16,Rookie,8,30,61,36,97,46,11,57,0.6288659793814433,0.8070175438596491
623,DSL Phillies Red,2021,16,Rookie,9,24,41,23,64,21,20,41,0.640625,0.5121951219512195
623,DSL Phillies Red,2021,16,Rookie,10,2,2,3,5,6,2,8,0.4,0.75
624,DSL PIT Black,2021,16,Rookie,7,15,17,6,23,18,7,25,0.7391304347826086,0.72
624,DSL PIT Black,2021,16,Rookie,8,30,27,17,44,38,9,47,0.6136363636363636,0.8085106382978723
624,DSL PIT Black,2021,16,Rookie,9,25,26,8,34,20,11,31,0.7647058823529411,0.6451612903225806
624,DSL PIT Black,2021,16,Rookie,10,2,1,1,2,1,0,1,0.5,1.0
625,DSL Rangers 1,2021,16,Rookie,7,18,23,8,31,43,22,65,0.7419354838709677,0.6615384615384615
625,DSL Rangers 1,2021,16,Rookie,8,27,50,12,62,42,16,58,0.8064516129032258,0.7241379310344828
625,DSL Rangers 1,2021,16,Rookie,9,26,25,13,38,58,9,67,0.6578947368421053,0.8656716417910447
625,DSL Rangers 1,2021,16,Rookie,10,4,7,1,8,16,0,16,0.875,1.0
626,DSL BOS Blue,2021,16,Rookie,7,18,19,21,40,17,9,26,0.475,0.6538461538461539
626,DSL BOS Blue,2021,16,Rookie,8,33,43,13,56,47,15,62,0.7678571428571429,0.7580645161290323
626,DSL BOS Blue,2021,16,Rookie,9,25,22,18,40,19,6,25,0.55,0.76
626,DSL BOS Blue,2021,16,Rookie,10,2,12,1,13,0,2,2,0.9230769230769231,0.0
627,DSL BOS Red,2021,16,Rookie,7,20,24,13,37,28,15,43,0.6486486486486487,0.6511627906976745
627,DSL BOS Red,2021,16,Rookie,8,45,45,12,57,50,39,89,0.7894736842105263,0.5617977528089888
627,DSL BOS Red,2021,16,Rookie,9,30,21,13,34,50,13,63,0.6176470588235294,0.7936507936507936
627,DSL BOS Red,2021,16,Rookie,10,2,0,0,0,9,0,9,,1.0
628,DSL Reds,2021,16,Rookie,7,15,39,17,56,21,12,33,0.6964285714285714,0.6363636363636364
628,DSL Reds,2021,16,Rookie,8,28,42,14,56,45,20,65,0.75,0.6923076923076923
628,DSL Reds,2021,16,Rookie,9,29,45,19,64,21,12,33,0.703125,0.6363636363636364
628,DSL Reds,2021,16,Rookie,10,2,2,2,4,6,2,8,0.5,0.75
629,DSL Rockies,2021,16,Rookie,7,16,32,7,39,26,11,37,0.8205128205128205,0.7027027027027027
629,DSL Rockies,2021,16,Rookie,8,28,38,19,57,37,16,53,0.6666666666666666,0.6981132075471698
629,DSL Rockies,2021,16,Rookie,9,23,22,11,33,28,9,37,0.6666666666666666,0.7567567567567568
629,DSL Rockies,2021,16,Rookie,10,2,4,1,5,3,1,4,0.8,0.75
630,DSL Royals Blue,2021,16,Rookie,7,23,19,16,35,24,10,34,0.5428571428571428,0.7058823529411765
630,DSL Royals Blue,2021,16,Rookie,8,67,71,24,95,67,12,79,0.7473684210526316,0.8481012658227848
630,DSL Royals Blue,2021,16,Rookie,9,37,54,13,67,34,21,55,0.8059701492537313,0.6181818181818182
630,DSL Royals Blue,2021,16,Rookie,10,4,3,0,3,4,0,4,1.0,1.0
631,DSL Tigers,2021,16,Rookie,7,15,24,11,35,19,6,25,0.6857142857142857,0.76
631,DSL Tigers,2021,16,Rookie,8,31,57,25,82,49,7,56,0.6951219512195121,0.875
631,DSL Tigers,2021,16,Rookie,9,30,41,25,66,38,15,53,0.6212121212121212,0.7169811320754716
631,DSL Tigers,2021,16,Rookie,10,2,1,0,1,2,0,2,1.0,1.0
632,DSL Twins,2021,16,Rookie,7,15,31,9,40,23,10,33,0.775,0.696969696969697
632,DSL Twins,2021,16,Rookie,8,27,26,6,32,82,17,99,0.8125,0.8282828282828283
632,DSL Twins,2021,16,Rookie,9,28,26,10,36,53,18,71,0.7222222222222222,0.7464788732394366
632,DSL Twins,2021,16,Rookie,10,2,2,1,3,7,3,10,0.6666666666666666,0.7
633,DSL White Sox,2021,16,Rookie,7,15,30,10,40,18,11,29,0.75,0.6206896551724138
633,DSL White Sox,2021,16,Rookie,8,26,44,17,61,47,12,59,0.7213114754098361,0.7966101694915254
633,DSL White Sox,2021,16,Rookie,9,26,52,18,70,20,28,48,0.7428571428571429,0.4166666666666667
633,DSL White Sox,2021,16,Rookie,10,2,2,1,3,0,1,1,0.6666666666666666,0.0
634,DSL Yankees 1,2021,16,Rookie,7,16,42,17,59,29,7,36,0.711864406779661,0.8055555555555556
634,DSL Yankees 1,2021,16,Rookie,8,39,105,32,137,57,44,101,0.7664233576642335,0.5643564356435643
634,DSL Yankees 1,2021,16,Rookie,9,26,44,20,64,34,21,55,0.6875,0.6181818181818182
634,DSL Yankees 1,2021,16,Rookie,10,2,2,0,2,3,1,4,1.0,0.75
635,DSL Yankees 2,2021,16,Rookie,7,16,41,13,54,31,21,52,0.7592592592592593,0.5961538461538461
635,DSL Yankees 2,2021,16,Rookie,8,39,78,38,116,82,23,105,0.6724137931034483,0.780952380952381
635,DSL Yankees 2,2021,16,Rookie,9,26,50,17,67,44,22,66,0.746268656716418,0.6666666666666666
635,DSL Yankees 2,2021,16,Rookie,10,2,2,0,2,0,0,0,1.0,
1270,DSL Nationals,2021,16,Rookie,7,16,18,9,27,18,12,30,0.6666666666666666,0.6
1270,DSL Nationals,2021,16,Rookie,8,30,29,9,38,33,34,67,0.7631578947368421,0.4925373134328358
1270,DSL Nationals,2021,16,Rookie,9,32,28,16,44,19,25,44,0.6363636363636364,0.4318181818181818
1270,DSL Nationals,2021,16,Rookie,10,2,0,1,1,0,1,1,0.0,0.0
1350,Northwest Arkansas Naturals,2021,12,AA,8,29,37,12,49,9,7,16,0.7551020408163265,0.5625
1350,Northwest Arkansas Naturals,2021,12,AA,9,17,14,6,20,13,4,17,0.7,0.7647058823529411
1370,FCL Cardinals,2021,16,Rookie,6,2,0,0,0,2,3,5,,0.4
1370,FCL Cardinals,2021,16,Rookie,7,33,26,18,44,15,9,24,0.5909090909090909,0.625
1370,FCL Cardinals,2021,16,Rookie,8,31,29,13,42,23,14,37,0.6904761904761905,0.6216216216216216
1370,FCL Cardinals,2021,16,Rookie,9,14,13,8,21,12,3,15,0.6190476190476191,0.8
1390,FCL Blue Jays,2021,16,Rookie,6,2,3,1,4,2,2,4,0.75,0.5
1390,FCL Blue Jays,2021,16,Rookie,7,33,58,12,70,20,10,30,0.8285714285714286,0.6666666666666666
1390,FCL Blue Jays,2021,16,Rookie,8,33,73,22,95,43,8,51,0.7684210526315789,0.8431372549019608
1390,FCL Blue Jays,2021,16,Rookie,9,16,13,9,22,10,5,15,0.5909090909090909,0.6666666666666666
1410,Lehigh Valley IronPigs,2022,11,AAA,4,32,32,3,35,43,11,54,0.9142857142857143,0.7962962962962963
1410,Lehigh Valley IronPigs,2022,11,AAA,5,29,30,13,43,35,8,43,0.6976744186046512,0.813953488372093
1410,Lehigh Valley IronPigs,2022,11,AAA,6,7,14,0,14,16,0,16,1.0,1.0
1611,DSL Rays 1,2021,16,Rookie,7,21,39,28,67,37,23,60,0.582089552238806,0.6166666666666667
1611,DSL Rays 1,2021,16,Rookie,8,39,88,51,139,40,26,66,0.6330935251798561,0.6060606060606061
1611,DSL Rays 1,2021,16,Rookie,9,30,56,30,86,44,18,62,0.6511627906976745,0.7096774193548387
1611,DSL Rays 1,2021,16,Rookie,10,2,4,6,10,4,3,7,0.4,0.5714285714285714
1956,Somerset Patriots,2021,12,AA,8,25,46,3,49,13,5,18,0.9387755102040817,0.7222222222222222
1956,Somerset Patriots,2021,12,AA,9,23,36,17,53,17,5,22,0.6792452830188679,0.7727272727272727
1960,St. Paul Saints,2022,11,AAA,4,27,22,3,25,27,9,36,0.88,0.75
1960,St. Paul Saints,2022,11,AAA,5,31,25,5,30,26,12,38,0.8333333333333334,0.6842105263157895
1960,St. Paul Saints,2022,11,AAA,6,3,1,0,1,4,1,5,1.0,0.8
1991,ACL D-backs,2021,16,Rookie,6,2,2,0,2,2,0,2,1.0,1.0
1991,ACL D-backs,2021,16,Rookie,7,30,48,16,64,46,13,59,0.75,0.7796610169491526
1991,ACL D-backs,2021,16,Rookie,8,27,49,13,62,27,16,43,0.7903225806451613,0.627906976744186
1991,ACL D-backs,2021,16,Rookie,9,13,8,5,13,17,5,22,0.6153846153846154,0.7727272727272727
1994,ACL Rockies,2021,16,Rookie,6,2,2,3,5,2,0,2,0.4,1.0
1994,ACL Rockies,2021,16,Rookie,7,29,56,14,70,18,13,31,0.8,0.5806451612903226
1994,ACL Rockies,2021,16,Rookie,8,25,32,21,53,33,9,42,0.6037735849056604,0.7857142857142857
1994,ACL Rockies,2021,16,Rookie,9,13,40,10,50,5,5,10,0.8,0.5
1996,ACL Royals Gold,2021,16,Rookie,6,2,1,0,1,1,0,1,1.0,1.0
1996,ACL Royals Gold,2021,16,Rookie,7,27,22,9,31,55,10,65,0.7096774193548387,0.8461538461538461
1996,ACL Royals Gold,2021,16,Rookie,8,24,26,6,32,15,4,19,0.8125,0.7894736842105263
1996,ACL Royals Gold,2021,16,Rookie,9,13,17,5,22,13,2,15,0.7727272727272727,0.8666666666666667
1997,ACL White Sox,2021,16,Rookie,6,2,0,0,0,2,2,4,,0.5
1997,ACL White Sox,2021,16,Rookie,7,25,15,7,22,27,13,40,0.6818181818181818,0.675
1997,ACL White Sox,2021,16,Rookie,8,26,11,6,17,35,7,42,0.6470588235294118,0.8333333333333334
1997,ACL White Sox,2021,16,Rookie,9,13,7,4,11,13,3,16,0.6363636363636364,0.8125
1998,FCL Astros,2021,16,Rookie,6,4,5,2,7,4,4,8,0.7142857142857143,0.5
1998,FCL Astros,2021,16,Rookie,7,26,22,9,31,22,13,35,0.7096774193548387,0.6285714285714286
1998,FCL Astros,2021,16,Rookie,8,37,43,37,80,35,14,49,0.5375,0.7142857142857143
1998,FCL Astros,2021,16,Rookie,9,23,45,14,59,26,14,40,0.7627118644067796,0.65
2003,FCL Rays,2021,16,Rookie,6,2,4,1,5,3,0,3,0.8,1.0
2003,FCL Rays,2021,16,Rookie,7,29,66,19,85,34,12,46,0.7764705882352941,0.7391304347826086
2003,FCL Rays,2021,16,Rookie,8,38,63,22,85,20,11,31,0.7411764705882353,0.6451612903225806
2003,FCL Rays,2021,16,Rookie,9,20,60,17,77,13,8,21,0.7792207792207793,0.6190476190476191
2097,DSL Cardinals Red,2021,16,Rookie,7,16,15,5,20,12,13,25,0.75,0.48
2097,DSL Cardinals Red,2021,16,Rookie,8,35,45,21,66,28,15,43,0.6818181818181818,0.6511627906976745
2097,DSL Cardinals Red,2021,16,Rookie,9,25,19,13,32,32,24,56,0.59375,0.5714285714285714
2097,DSL Cardinals Red,2021,16,Rookie,10,2,3,1,4,3,1,4,0.75,0.75
2101,DSL Brewers 2,2021,16,Rookie,7,16,18,9,27,26,13,39,0.6666666666666666,0.6666666666666666
2101,DSL Brewers 2,2021,16,Rookie,8,29,45,14,59,38,9,47,0.7627118644067796,0.8085106382978723
2101,DSL Brewers 2,2021,16,Rookie,9,25,22,8,30,35,15,50,0.7333333333333333,0.7
2101,DSL Brewers 2,2021,16,Rookie,10,2,5,0,5,2,1,3,1.0,0.6666666666666666
2117,DSL Mets 2,2021,16,Rookie,7,15,6,7,13,29,6,35,0.46153846153846156,0.8285714285714286
2117,DSL Mets 2,2021,16,Rookie,8,26,31,14,45,31,15,46,0.6888888888888889,0.6739130434782609
2117,DSL Mets 2,2021,16,Rookie,9,23,12,8,20,43,6,49,0.6,0.8775510204081632
2117,DSL Mets 2,2021,16,Rookie,10,2,6,0,6,1,2,3,1.0,0.3333333333333333
2128,DSL Royals White,2021,16,Rookie,7,18,23,7,30,25,9,34,0.7666666666666667,0.7352941176470589
2128,DSL Royals White,2021,16,Rookie,8,56,62,26,88,87,3,90,0.7045454545454546,0.9666666666666667
2128,DSL Royals White,2021,16,Rookie,9,37,35,19,54,57,12,69,0.6481481481481481,0.8260869565217391
2128,DSL Royals White,2021,16,Rookie,10,4,7,0,7,4,0,4,1.0,1.0
2131,DSL Colorado,2021,16,Rookie,7,17,39,14,53,21,11,32,0.7358490566037735,0.65625
2131,DSL Colorado,2021,16,Rookie,8,31,71,21,92,25,16,41,0.7717391304347826,0.6097560975609756
2131,DSL Colorado,2021,16,Rookie,9,25,29,18,47,12,11,23,0.6170212765957447,0.5217391304347826
2131,DSL Colorado,2021,16,Rookie,10,2,3,1,4,2,0,2,0.75,1.0
2134,DSL Giants Black,2021,16,Rookie,7,15,18,8,26,18,3,21,0.6923076923076923,0.8571428571428571
2134,DSL Giants Black,2021,16,Rookie,8,30,33,10,43,39,10,49,0.7674418604651163,0.7959183673469388
2134,DSL Giants Black,2021,16,Rookie,9,25,25,9,34,29,12,41,0.7352941176470589,0.7073170731707317
2134,DSL Giants Black,2021,16,Rookie,10,2,1,2,3,2,0,2,0.3333333333333333,1.0
2270,DSL Cubs Red,2021,16,Rookie,7,15,11,9,20,23,8,31,0.55,0.7419354838709677
2270,DSL Cubs Red,2021,16,Rookie,8,27,45,18,63,59,24,83,0.7142857142857143,0.7108433734939759
2270,DSL Cubs Red,2021,16,Rookie,9,25,64,32,96,49,15,64,0.6666666666666666,0.765625
2270,DSL Cubs Red,2021,16,Rookie,10,2,4,3,7,3,1,4,0.5714285714285714,0.75
2310,Reno Aces,2022,11,AAA,4,23,22,8,30,24,1,25,0.7333333333333333,0.96
2310,Reno Aces,2022,11,AAA,5,29,45,14,59,36,6,42,0.7627118644067796,0.8571428571428571
2310,Reno Aces,2022,11,AAA,6,3,1,1,2,4,3,7,0.5,0.5714285714285714
2413,DSL Rangers 2,2021,16,Rookie,7,15,52,11,63,20,3,23,0.8253968253968254,0.8695652173913043
2413,DSL Rangers 2,2021,16,Rookie,8,26,54,18,72,46,12,58,0.75,0.7931034482758621
2413,DSL Rangers 2,2021,16,Rookie,9,24,50,8,58,27,15,42,0.8620689655172413,0.6428571428571429
2413,DSL Rangers 2,2021,16,Rookie,10,4,14,0,14,7,2,9,1.0,0.7777777777777778
2498,Bowling Green Hot Rods,2021,13,High-A,5,27,36,12,48,17,12,29,0.75,0.5862068965517241
2498,Bowling Green Hot Rods,2021,13,High-A,6,28,29,11,40,29,5,34,0.725,0.8529411764705882
2498,Bowling Green Hot Rods,2021,13,High-A,7,34,39,14,53,32,7,39,0.7358490566037735,0.8205128205128205
2498,Bowling Green Hot Rods,2021,13,High-A,8,27,21,8,29,28,5,33,0.7241379310344828,0.8484848484848485
2498,Bowling Green Hot Rods,2021,13,High-A,9,22,14,8,22,6,6,12,0.6363636363636364,0.5
3130,DSL Orioles 2,2021,16,Rookie,7,15,15,8,23,19,7,26,0.6521739130434783,0.7307692307692307
3130,DSL Orioles 2,2021,16,Rookie,8,27,31,7,38,53,13,66,0.8157894736842105,0.803030303030303
3130,DSL Orioles 2,2021,16,Rookie,9,25,36,15,51,32,15,47,0.7058823529411765,0.6808510638297872
3130,DSL Orioles 2,2021,16,Rookie,10,2,1,1,2,1,0,1,0.5,1.0
3390,Bradenton Marauders,2021,14,A,5,24,42,5,47,28,2,30,0.8936170212765957,0.9333333333333333
3390,Bradenton Marauders,2021,14,A,6,25,15,6,21,28,8,36,0.7142857142857143,0.7777777777777778
3390,Bradenton Marauders,2021,14,A,7,33,27,5,32,40,15,55,0.84375,0.7272727272727273
3390,Bradenton Marauders,2021,14,A,8,50,28,9,37,70,17,87,0.7567567567567568,0.8045977011494253
3390,Bradenton Marauders,2021,14,A,9,23,6,7,13,17,5,22,0.46153846153846156,0.7727272727272727
3410,Richmond Flying Squirrels,2021,12,AA,8,25,8,3,11,15,13,28,0.7272727272727273,0.5357142857142857
3410,Richmond Flying Squirrels,2021,12,AA,9,17,7,1,8,6,5,11,0.875,0.5454545454545454
3430,ACL Reds,2021,16,Rookie,6,2,2,4,6,1,0,1,0.3333333333333333,1.0
3430,ACL Reds,2021,16,Rookie,7,27,40,16,56,25,17,42,0.7142857142857143,0.5952380952380952
3430,ACL Reds,2021,16,Rookie,8,24,34,18,52,16,13,29,0.6538461538461539,0.5517241379310345
3430,ACL Reds,2021,16,Rookie,9,13,16,4,20,24,4,28,0.8,0.8571428571428571
3705,Columbia Fireflies,2021,14,A,5,27,36,13,49,28,10,38,0.7346938775510204,0.7368421052631579
3705,Columbia Fireflies,2021,14,A,6,26,55,7,62,19,11,30,0.8870967741935484,0.6333333333333333
3705,Columbia Fireflies,2021,14,A,7,39,67,16,83,34,14,48,0.8072289156626506,0.7083333333333334
3705,Columbia Fireflies,2021,14,A,8,29,54,12,66,23,9,32,0.8181818181818182,0.71875
3705,Columbia Fireflies,2021,14,A,9,23,19,6,25,17,6,23,0.76,0.7391304347826086
3712,Fayetteville Woodpeckers,2021,14,A,5,24,45,8,53,29,1,30,0.8490566037735849,0.9666666666666667
3712,Fayetteville Woodpeckers,2021,14,A,6,25,59,15,74,51,2,53,0.7972972972972973,0.9622641509433962
3712,Fayetteville Woodpeckers,2021,14,A,7,35,68,23,91,49,24,73,0.7472527472527473,0.6712328767123288
3712,Fayetteville Woodpeckers,2021,14,A,8,32,46,13,59,54,8,62,0.7796610169491526,0.8709677419354839
3712,Fayetteville Woodpeckers,2021,14,A,9,17,17,6,23,29,10,39,0.7391304347826086,0.7435897435897436
3898,Wichita Wind Surge,2021,12,AA,8,23,29,6,35,10,9,19,0.8285714285714286,0.5263157894736842
3898,Wichita Wind Surge,2021,12,AA,9,20,27,4,31,24,8,32,0.8709677419354839,0.75
4124,Pensacola Blue Wahoos,2021,12,AA,8,26,13,12,25,19,8,27,0.52,0.7037037037037037
4124,Pensacola Blue Wahoos,2021,12,AA,9,17,9,5,14,18,5,23,0.6428571428571429,0.782608695652174
4404,DSL PIT Gold,2021,16,Rookie,7,15,11,15,26,20,7,27,0.4230769230769231,0.7407407407407407
4404,DSL PIT Gold,2021,16,Rookie,8,28,25,15,40,66,9,75,0.625,0.88
4404,DSL PIT Gold,2021,16,Rookie,9,27,22,14,36,50,9,59,0.6111111111111112,0.847457627118644
4404,DSL PIT Gold,2021,16,Rookie,10,2,1,0,1,2,0,2,1.0,1.0
4904,El Paso Chihuahuas,2022,11,AAA,4,23,13,8,21,18,7,25,0.6190476190476191,0.72
4904,El Paso Chihuahuas,2022,11,AAA,5,26,17,6,23,29,12,41,0.7391304347826086,0.7073170731707317
4904,El Paso Chihuahuas,2022,11,AAA,6,3,2,0,2,2,0,2,1.0,1.0
5015,Biloxi Shuckers,2021,12,AA,8,23,17,6,23,10,11,21,0.7391304347826086,0.47619047619047616
5015,Biloxi Shuckers,2021,12,AA,9,20,23,2,25,7,5,12,0.92,0.5833333333333334
5071,FCL Tigers West,2021,16,Rookie,6,2,4,3,7,4,2,6,0.5714285714285714,0.6666666666666666
5071,FCL Tigers West,2021,16,Rookie,7,36,14,9,23,59,6,65,0.6086956521739131,0.9076923076923077
5071,FCL Tigers West,2021,16,Rookie,8,23,23,5,28,28,19,47,0.8214285714285714,0.5957446808510638
5071,FCL Tigers West,2021,16,Rookie,9,16,3,2,5,16,9,25,0.6,0.64
5085,DSL Phillies White,2021,16,Rookie,7,16,23,14,37,16,15,31,0.6216216216216216,0.5161290322580645
5085,DSL Phillies White,2021,16,Rookie,8,32,61,22,83,25,27,52,0.7349397590361446,0.4807692307692308
5085,DSL Phillies White,2021,16,Rookie,9,28,34,20,54,26,16,42,0.6296296296296297,0.6190476190476191
5085,DSL Phillies White,2021,16,Rookie,10,2,8,1,9,2,2,4,0.8888888888888888,0.5
5086,DSL Rays 2,2021,16,Rookie,7,18,27,15,42,16,11,27,0.6428571428571429,0.5925925925925926
5086,DSL Rays 2,2021,16,Rookie,8,39,64,24,88,55,37,92,0.7272727272727273,0.5978260869565217
5086,DSL Rays 2,2021,16,Rookie,9,30,63,28,91,31,21,52,0.6923076923076923,0.5961538461538461
5086,DSL Rays 2,2021,16,Rookie,10,2,7,3,10,2,4,6,0.7,0.3333333333333333
5087,DSL D-backs 2,2021,16,Rookie,7,16,18,16,34,27,15,42,0.5294117647058824,0.6428571428571429
5087,DSL D-backs 2,2021,16,Rookie,8,28,12,14,26,36,18,54,0.46153846153846156,0.6666666666666666
5087,DSL D-backs 2,2021,16,Rookie,9,23,21,12,33,29,14,43,0.6363636363636364,0.6744186046511628
5087,DSL D-backs 2,2021,16,Rookie,10,2,0,1,1,3,1,4,0.0,0.75
5368,Amarillo Sod Poodles,2021,12,AA,8,24,17,8,25,18,6,24,0.68,0.75
5368,Amarillo Sod Poodles,2021,12,AA,9,21,20,10,30,20,2,22,0.6666666666666666,0.9090909090909091
5370,ACL Giants Orange,2021,16,Rookie,6,2,2,1,3,1,2,3,0.6666666666666666,0.3333333333333333
5370,ACL Giants Orange,2021,16,Rookie,7,31,35,5,40,30,19,49,0.875,0.6122448979591837
5370,ACL Giants Orange,2021,16,Rookie,8,25,27,5,32,27,6,33,0.84375,0.8181818181818182
5370,ACL Giants Orange,2021,16,Rookie,9,16,12,3,15,11,4,15,0.8,0.7333333333333333
5374,ACL Indians,2021,16,Rookie,6,2,1,3,4,1,1,2,0.25,0.5
5374,ACL Indians,2021,16,Rookie,7,25,32,16,48,45,18,63,0.6666666666666666,0.7142857142857143
5374,ACL Indians,2021,16,Rookie,8,27,22,13,35,40,16,56,0.6285714285714286,0.7142857142857143
5374,ACL Indians,2021,16,Rookie,9,15,19,5,24,12,4,16,0.7916666666666666,0.75
5426,ACL Athletics,2021,16,Rookie,6,2,0,0,0,1,0,1,,1.0
5426,ACL Athletics,2021,16,Rookie,7,30,10,8,18,48,4,52,0.5555555555555556,0.9230769230769231
5426,ACL Athletics,2021,16,Rookie,8,24,14,6,20,22,8,30,0.7,0.7333333333333333
5426,ACL Athletics,2021,16,Rookie,9,13,8,3,11,16,6,22,0.7272727272727273,0.7272727272727273
5427,ACL Dodgers,2021,16,Rookie,6,2,2,0,2,0,2,2,1.0,0.0
5427,ACL Dodgers,2021,16,Rookie,7,25,15,8,23,25,12,37,0.6521739130434783,0.6756756756756757
5427,ACL Dodgers,2021,16,Rookie,8,26,10,5,15,17,5,22,0.6666666666666666,0.7727272727272727
5427,ACL Dodgers,2021,16,Rookie,9,13,7,3,10,21,6,27,0.7,0.7777777777777778
5430,ACL Brewers Blue,2021,16,Rookie,6,2,0,0,0,0,0,0,,
5430,ACL Brewers Blue,2021,16,Rookie,7,26,29,19,48,21,14,35,0.6041666666666666,0.6
5430,ACL Brewers Blue,2021,16,Rookie,8,31,29,19,48,16,17,33,0.6041666666666666,0.48484848484848486
5430,ACL Brewers Blue,2021,16,Rookie,9,13,19,6,25,19,5,24,0.76,0.7916666666666666
5434,Sugar Land Space Cowboys,2022,11,AAA,4,23,28,7,35,28,9,37,0.8,0.7567567567567568
5434,Sugar Land Space Cowboys,2022,11,AAA,5,26,26,8,34,14,6,20,0.7647058823529411,0.7
5434,Sugar Land Space Cowboys,2022,11,AAA,6,3,3,2,5,5,1,6,0.6,0.8333333333333334
5506,DSL Indians Red,2021,16,Rookie,7,16,28,13,41,29,15,44,0.6829268292682927,0.6590909090909091
5506,DSL Indians Red,2021,16,Rookie,8,38,42,24,66,48,22,70,0.6363636363636364,0.6857142857142857
5506,DSL Indians Red,2021,16,Rookie,9,30,31,13,44,48,14,62,0.7045454545454546,0.7741935483870968
5506,DSL Indians Red,2021,16,Rookie,10,2,1,0,1,5,1,6,1.0,0.8333333333333334
5578,FCL Orioles Orange,2021,16,Rookie,6,2,0,1,1,1,1,2,0.0,0.5
5578,FCL Orioles Orange,2021,16,Rookie,7,34,50,22,72,53,9,62,0.6944444444444444,0.8548387096774194
5578,FCL Orioles Orange,2021,16,Rookie,8,37,39,17,56,45,11,56,0.6964285714285714,0.8035714285714286
5578,FCL Orioles Orange,2021,16,Rookie,9,22,12,6,18,7,5,12,0.6666666666666666,0.5833333333333334
5579,FCL Pirates Gold,2021,16,Rookie,6,2,3,0,3,4,1,5,1.0,0.8
5579,FCL Pirates Gold,2021,16,Rookie,7,29,33,11,44,33,17,50,0.75,0.66
5579,FCL Pirates Gold,2021,16,Rookie,8,38,82,8,90,75,31,106,0.9111111111111111,0.7075471698113207
5579,FCL Pirates Gold,2021,16,Rookie,9,18,24,15,39,12,0,12,0.6153846153846154,1.0
