team_id,team_name,season,level_id,level_name,month,games,sb,cs,attempts,sb_allowed,cs_allowed,attempts_allowed,success_rate,success_rate_allowed
102,Round Rock Express,2019,11,AAA,4,35,21,13,34,16,6,22,0.6176470588235294,0.7272727272727273
102,Round Rock Express,2019,11,AAA,5,37,40,5,45,34,6,40,0.8888888888888888,0.85
102,Round Rock Express,2019,11,AAA,6,27,24,7,31,9,6,15,0.7741935483870968,0.6
102,Round Rock Express,2019,11,AAA,7,29,36,9,45,13,8,21,0.8,0.6190476190476191
102,Round Rock Express,2019,11,AAA,8,31,35,13,48,11,5,16,0.7291666666666666,0.6875
102,Round Rock Express,2019,11,AAA,9,2,2,1,3,2,0,2,0.6666666666666666,1.0
103,Lake Elsinore Storm,2019,13,High-A,4,29,37,9,46,25,10,35,0.8043478260869565,0.7142857142857143
103,Lake Elsinore Storm,2019,13,High-A,5,38,37,10,47,24,7,31,0.7872340425531915,0.7741935483870968
103,Lake Elsinore Storm,2019,13,High-A,6,26,32,7,39,26,10,36,0.8205128205128205,0.7222222222222222
103,Lake Elsinore Storm,2019,13,High-A,7,27,33,16,49,23,14,37,0.673469387755102,0.6216216216216216
103,Lake Elsinore Storm,2019,13,High-A,8,22,20,7,27,17,9,26,0.7407407407407407,0.6538461538461539
103,Lake Elsinore Storm,2019,13,High-A,9,2,1,0,1,1,1,2,1.0,0.5
104,Jackson Generals,2019,12,AA,4,34,20,6,26,26,6,32,0.7692307692307693,0.8125
104,Jackson Generals,2019,12,AA,5,38,10,5,15,31,5,36,0.6666666666666666,0.8611111111111112
104,Jackson Generals,2019,12,AA,6,38,21,7,28,38,6,44,0.75,0.8636363636363636
104,Jackson Generals,2019,12,AA,7,32,16,7,23,33,14,47,0.6956521739130435,0.7021276595744681
104,Jackson Generals,2019,12,AA,8,31,17,5,22,18,12,30,0.7727272727272727,0.6
104,Jackson Generals,2019,12,AA,9,2,0,0,0,0,0,0,,
105,Sacramento River Cats,2019,11,AAA,4,27,13,8,21,20,12,32,0.6190476190476191,0.625
105,Sacramento River Cats,2019,11,AAA,5,36,7,13,20,10,10,20,0.35,0.5
105,Sacramento River Cats,2019,11,AAA,6,27,12,3,15,14,11,25,0.8,0.56
105,Sacramento River Cats,2019,11,AAA,7,28,10,10,20,7,8,15,0.5,0.4666666666666667
105,Sacramento River Cats,2019,11,AAA,8,29,10,5,15,5,5,10,0.6666666666666666,0.5
105,Sacramento River Cats,2019,11,AAA,9,2,1,0,1,1,2,3,1.0,0.3333333333333333
106,Erie SeaWolves,2019,12,AA,4,37,22,18,40,22,8,30,0.55,0.7333333333333333
106,Erie SeaWolves,2019,12,AA,5,30,16,5,21,23,15,38,0.7619047619047619,0.6052631578947368
106,Erie SeaWolves,2019,12,AA,6,42,24,11,35,26,17,43,0.6857142857142857,0.6046511627906976
106,Erie SeaWolves,2019,12,AA,7,35,27,9,36,21,13,34,0.75,0.6176470588235294
106,Erie SeaWolves,2019,12,AA,8,35,16,11,27,28,26,54,0.5925925925925926,0.5185185185185185
106,Erie SeaWolves,2019,12,AA,9,2,2,1,3,0,0,0,0.6666666666666666,
233,Charleston RiverDogs,2019,14,A,4,24,18,11,29,22,8,30,0.6206896551724138,0.7333333333333333
234,Durham Bulls,2019,11,AAA,4,32,22,12,34,10,14,24,0.6470588235294118,0.4166666666666667
234,Durham Bulls,2019,11,AAA,5,29,20,8,28,9,7,16,0.7142857142857143,0.5625
234,Durham Bulls,2019,11,AAA,6,35,31,7,38,15,11,26,0.8157894736842105,0.5769230769230769
234,Durham Bulls,2019,11,AAA,7,29,10,7,17,20,7,27,0.5882352941176471,0.7407407407407407
234,Durham Bulls,2019,11,AAA,8,28,13,10,23,9,6,15,0.5652173913043478,0.6
234,Durham Bulls,2019,11,AAA,9,2,0,1,1,2,1,3,0.0,0.6666666666666666
235,Memphis Redbirds,2019,11,AAA,4,36,22,6,28,13,13,26,0.7857142857142857,0.5
235,Memphis Redbirds,2019,11,AAA,5,35,31,10,41,22,14,36,0.7560975609756098,0.6111111111111112
235,Memphis Redbirds,2019,11,AAA,6,27,15,9,24,13,8,21,0.625,0.6190476190476191
235,Memphis Redbirds,2019,11,AAA,7,29,14,12,26,14,7,21,0.5384615384615384,0.6666666666666666
235,Memphis Redbirds,2019,11,AAA,8,32,15,8,23,18,8,26,0.6521739130434783,0.6923076923076923
235,Memphis Redbirds,2019,11,AAA,9,2,1,0,1,2,0,2,1.0,1.0
237,Midland RockHounds,2019,12,AA,4,37,30,6,36,14,19,33,0.8333333333333334,0.42424242424242425
237,Midland RockHounds,2019,12,AA,5,31,19,14,33,16,10,26,0.5757575757575758,0.6153846153846154
237,Midland RockHounds,2019,12,AA,6,26,29,12,41,15,11,26,0.7073170731707317,0.5769230769230769
237,Midland RockHounds,2019,12,AA,7,28,23,10,33,14,10,24,0.696969696969697,0.5833333333333334
237,Midland RockHounds,2019,12,AA,8,33,9,11,20,35,20,55,0.45,0.6363636363636364
237,Midland RockHounds,2019,12,AA,9,2,1,3,4,1,1,2,0.25,0.5
238,Oklahoma City Dodgers,2019,11,AAA,4,35,20,5,25,35,8,43,0.8,0.813953488372093
238,Oklahoma City Dodgers,2019,11,AAA,5,35,9,6,15,32,15,47,0.6,0.6808510638297872
238,Oklahoma City Dodgers,2019,11,AAA,6,27,8,4,12,29,8,37,0.6666666666666666,0.7837837837837838
238,Oklahoma City Dodgers,2019,11,AAA,7,28,4,2,6,16,10,26,0.6666666666666666,0.6153846153846154
238,Oklahoma City Dodgers,2019,11,AAA,8,31,5,8,13,28,5,33,0.38461538461538464,0.8484848484848485
238,Oklahoma City Dodgers,2019,11,AAA,9,2,0,0,0,0,1,1,,0.0
247,Birmingham Barons,2019,12,AA,4,34,20,20,40,33,20,53,0.5,0.6226415094339622
247,Birmingham Barons,2019,12,AA,5,33,24,17,41,28,22,50,0.5853658536585366,0.56
247,Birmingham Barons,2019,12,AA,6,40,45,17,62,36,7,43,0.7258064516129032,0.8372093023255814
247,Birmingham Barons,2019,12,AA,7,29,22,12,34,27,2,29,0.6470588235294118,0.9310344827586207
247,Birmingham Barons,2019,12,AA,8,28,22,8,30,24,6,30,0.7333333333333333,0.8
247,Birmingham Barons,2019,12,AA,9,2,0,0,0,1,0,1,,1.0
249,Carolina Mudcats,2019,13,High-A,4,35,14,4,18,28,11,39,0.7777777777777778,0.717948717948718
249,Carolina Mudcats,2019,13,High-A,5,30,19,8,27,29,19,48,0.7037037037037037,0.6041666666666666
249,Carolina Mudcats,2019,13,High-A,6,31,17,14,31,24,9,33,0.5483870967741935,0.7272727272727273
249,Carolina Mudcats,2019,13,High-A,7,39,11,6,17,37,21,58,0.6470588235294118,0.6379310344827587
249,Carolina Mudcats,2019,13,High-A,8,26,8,4,12,18,5,23,0.6666666666666666,0.782608695652174
249,Carolina Mudcats,2019,13,High-A,9,2,2,0,2,2,1,3,1.0,0.6666666666666666
259,Fresno Grizzlies,2019,11,AAA,4,31,21,6,27,19,7,26,0.7777777777777778,0.7307692307692307
259,Fresno Grizzlies,2019,11,AAA,5,39,14,5,19,24,15,39,0.7368421052631579,0.6153846153846154
259,Fresno Grizzlies,2019,11,AAA,6,30,27,10,37,23,8,31,0.7297297297297297,0.7419354838709677
259,Fresno Grizzlies,2019,11,AAA,7,26,8,5,13,16,8,24,0.6153846153846154,0.6666666666666666
259,Fresno Grizzlies,2019,11,AAA,8,29,11,2,13,19,9,28,0.8461538461538461,0.6785714285714286
259,Fresno Grizzlies,2019,11,AAA,9,2,1,0,1,0,0,0,1.0,
260,Tulsa Drillers,2019,12,AA,4,35,7,12,19,30,8,38,0.3684210526315789,0.7894736842105263
260,Tulsa Drillers,2019,12,AA,5,36,7,5,12,48,13,61,0.5833333333333334,0.7868852459016393
260,Tulsa Drillers,2019,12,AA,6,29,15,4,19,11,6,17,0.7894736842105263,0.6470588235294118
260,Tulsa Drillers,2019,12,AA,7,28,14,9,23,23,11,34,0.6086956521739131,0.6764705882352942
260,Tulsa Drillers,2019,12,AA,8,33,29,17,46,29,18,47,0.6304347826086957,0.6170212765957447
260,Tulsa Drillers,2019,12,AA,9,2,0,0,0,0,1,1,,0.0
279,Palm Beach Cardinals,2019,13,High-A,4,28,6,8,14,16,13,29,0.42857142857142855,0.5517241379310345
279,Palm Beach Cardinals,2019,13,High-A,5,35,10,2,12,20,19,39,0.8333333333333334,0.5128205128205128
279,Palm Beach Cardinals,2019,13,High-A,6,34,5,6,11,29,19,48,0.45454545454545453,0.6041666666666666
279,Palm Beach Cardinals,2019,13,High-A,7,38,4,4,8,32,8,40,0.5,0.8
279,Palm Beach Cardinals,2019,13,High-A,8,26,1,3,4,30,7,37,0.25,0.8108108108108109
279,Palm Beach Cardinals,2019,13,High-A,9,1,0,0,0,0,0,0,,
342,Albuquerque Isotopes,2019,11,AAA,4,32,15,14,29,15,9,24,0.5172413793103449,0.625
342,Albuquerque Isotopes,2019,11,AAA,5,30,18,7,25,23,4,27,0.72,0.8518518518518519
342,Albuquerque Isotopes,2019,11,AAA,6,27,23,5,28,22,7,29,0.8214285714285714,0.7586206896551724
342,Albuquerque Isotopes,2019,11,AAA,7,32,21,7,28,2,10,12,0.75,0.16666666666666666
342,Albuquerque Isotopes,2019,11,AAA,8,29,10,7,17,17,8,25,0.5882352941176471,0.68
342,Albuquerque Isotopes,2019,11,AAA,9,2,0,0,0,1,0,1,,1.0
400,Las Vegas Aviators,2019,11,AAA,4,26,23,7,30,12,4,16,0.7666666666666667,0.75
400,Las Vegas Aviators,2019,11,AAA,5,36,24,10,34,11,10,21,0.7058823529411765,0.5238095238095238
400,Las Vegas Aviators,2019,11,AAA,6,27,13,7,20,11,4,15,0.65,0.7333333333333333
400,Las Vegas Aviators,2019,11,AAA,7,29,10,7,17,18,6,24,0.5882352941176471,0.75
400,Las Vegas Aviators,2019,11,AAA,8,29,12,8,20,20,8,28,0.6,0.7142857142857143
400,Las Vegas Aviators,2019,11,AAA,9,2,3,0,3,0,0,0,1.0,
401,Inland Empire 66ers,2019,13,High-A,4,26,15,7,22,45,13,58,0.6818181818181818,0.7758620689655172
401,Inland Empire 66ers,2019,13,High-A,5,41,17,3,20,46,22,68,0.85,0.6764705882352942
401,Inland Empire 66ers,2019,13,High-A,6,26,10,4,14,33,7,40,0.7142857142857143,0.825
401,Inland Empire 66ers,2019,13,High-A,7,27,10,9,19,29,12,41,0.5263157894736842,0.7073170731707317
401,Inland Empire 66ers,2019,13,High-A,8,23,10,5,15,20,9,29,0.6666666666666666,0.6896551724137931
401,Inland Empire 66ers,2019,13,High-A,9,2,4,1,5,2,1,3,0.8,0.6666666666666666
402,Akron RubberDucks,2019,12,AA,4,33,20,8,28,20,8,28,0.7142857142857143,0.7142857142857143
402,Akron RubberDucks,2019,12,AA,5,34,22,15,37,24,13,37,0.5945945945945946,0.6486486486486487
402,Akron RubberDucks,2019,12,AA,6,41,31,18,49,30,23,53,0.6326530612244898,0.5660377358490566
402,Akron RubberDucks,2019,12,AA,7,30,19,7,26,26,7,33,0.7307692307692307,0.7878787878787878
402,Akron RubberDucks,2019,12,AA,8,29,15,10,25,24,12,36,0.6,0.6666666666666666
402,Akron RubberDucks,2019,12,AA,9,2,0,0,0,2,1,3,,0.6666666666666666
414,Salem Red Sox,2019,13,High-A,4,36,39,23,62,31,8,39,0.6290322580645161,0.7948717948717948
414,Salem Red Sox,2019,13,High-A,5,35,13,12,25,33,20,53,0.52,0.6226415094339622
414,Salem Red Sox,2019,13,High-A,6,34,18,12,30,22,17,39,0.6,0.5641025641025641
414,Salem Red Sox,2019,13,High-A,7,42,10,31,41,27,35,62,0.24390243902439024,0.43548387096774194
414,Salem Red Sox,2019,13,High-A,8,31,14,5,19,23,10,33,0.7368421052631579,0.696969696969697
414,Salem Red Sox,2019,13,High-A,9,2,2,1,3,2,0,2,0.6666666666666666,1.0
416,Louisville Bats,2019,11,AAA,4,26,21,13,34,31,9,40,0.6176470588235294,0.775
416,Louisville Bats,2019,11,AAA,5,34,18,12,30,30,12,42,0.6,0.7142857142857143
416,Louisville Bats,2019,11,AAA,6,31,23,15,38,24,13,37,0.6052631578947368,0.6486486486486487
416,Louisville Bats,2019,11,AAA,7,27,12,10,22,29,9,38,0.5454545454545454,0.7631578947368421
416,Louisville Bats,2019,11,AAA,8,29,20,11,31,19,4,23,0.6451612903225806,0.8260869565217391
416,Louisville Bats,2019,11,AAA,9,2,4,0,4,0,0,0,1.0,
417,Mobile BayBears,2019,12,AA,4,38,21,6,27,19,14,33,0.7777777777777778,0.5757575757575758
417,Mobile BayBears,2019,12,AA,5,35,11,8,19,46,16,62,0.5789473684210527,0.7419354838709677
417,Mobile BayBears,2019,12,AA,6,40,42,7,49,32,21,53,0.8571428571428571,0.6037735849056604
417,Mobile BayBears,2019,12,AA,7,33,23,6,29,43,12,55,0.7931034482758621,0.7818181818181819
417,Mobile BayBears,2019,12,AA,8,33,14,12,26,19,9,28,0.5384615384615384,0.6785714285714286
417,Mobile BayBears,2019,12,AA,9,2,0,1,1,0,2,2,0.0,0.0
418,Bowie Baysox,2019,12,AA,4,33,13,9,22,20,9,29,0.5909090909090909,0.6896551724137931
418,Bowie Baysox,2019,12,AA,5,30,9,7,16,13,14,27,0.5625,0.48148148148148145
418,Bowie Baysox,2019,12,AA,6,27,16,10,26,11,15,26,0.6153846153846154,0.4230769230769231
418,Bowie Baysox,2019,12,AA,7,31,35,8,43,22,15,37,0.813953488372093,0.5945945945945946
418,Bowie Baysox,2019,12,AA,8,35,30,12,42,18,16,34,0.7142857142857143,0.5294117647058824
418,Bowie Baysox,2019,12,AA,9,2,0,0,0,2,0,2,,1.0
420,Burlington Bees,2019,14,A,4,25,21,4,25,22,13,35,0.84,0.6285714285714286
421,Montgomery Biscuits,2019,12,AA,4,32,38,18,56,12,13,25,0.6785714285714286,0.48
421,Montgomery Biscuits,2019,12,AA,5,29,36,15,51,20,10,30,0.7058823529411765,0.6666666666666666
421,Montgomery Biscuits,2019,12,AA,6,32,38,24,62,21,12,33,0.6129032258064516,0.6363636363636364
421,Montgomery Biscuits,2019,12,AA,7,32,68,31,99,19,13,32,0.6868686868686869,0.59375
421,Montgomery Biscuits,2019,12,AA,8,34,48,20,68,19,6,25,0.7058823529411765,0.76
421,Montgomery Biscuits,2019,12,AA,9,2,3,1,4,0,0,0,0.75,
422,Buffalo Bisons,2019,11,AAA,4,40,29,12,41,24,9,33,0.7073170731707317,0.7272727272727273
422,Buffalo Bisons,2019,11,AAA,5,36,33,10,43,21,8,29,0.7674418604651163,0.7241379310344828
422,Buffalo Bisons,2019,11,AAA,6,38,43,18,61,18,4,22,0.7049180327868853,0.8181818181818182
422,Buffalo Bisons,2019,11,AAA,7,32,26,11,37,24,3,27,0.7027027027027027,0.8888888888888888
422,Buffalo Bisons,2019,11,AAA,8,29,24,8,32,12,3,15,0.75,0.8
422,Buffalo Bisons,2019,11,AAA,9,2,2,1,3,3,0,3,0.6666666666666666,1.0
424,Dunedin Blue Jays,2019,13,High-A,4,26,37,13,50,17,6,23,0.74,0.7391304347826086
424,Dunedin Blue Jays,2019,13,High-A,5,42,24,9,33,25,6,31,0.7272727272727273,0.8064516129032258
424,Dunedin Blue Jays,2019,13,High-A,6,33,54,17,71,28,14,42,0.7605633802816901,0.6666666666666666
424,Dunedin Blue Jays,2019,13,High-A,7,57,48,12,60,60,7,67,0.8,0.8955223880597015
424,Dunedin Blue Jays,2019,13,High-A,8,41,53,11,64,8,10,18,0.828125,0.4444444444444444
426,Wilmington Blue Rocks,2019,13,High-A,4,35,34,29,63,18,15,33,0.5396825396825397,0.5454545454545454
426,Wilmington Blue Rocks,2019,13,High-A,5,32,30,20,50,12,10,22,0.6,0.5454545454545454
426,Wilmington Blue Rocks,2019,13,High-A,6,32,58,14,72,11,12,23,0.8055555555555556,0.4782608695652174
426,Wilmington Blue Rocks,2019,13,High-A,7,48,43,30,73,3,28,31,0.589041095890411,0.0967741935483871
426,Wilmington Blue Rocks,2019,13,High-A,8,28,26,18,44,15,15,30,0.5909090909090909,0.5
426,Wilmington Blue Rocks,2019,13,High-A,9,2,2,0,2,0,1,1,1.0,0.0
427,Lakewood BlueClaws,2019,14,A,4,21,28,13,41,28,7,35,0.6829268292682927,0.8
428,Greenville Drive,2019,14,A,4,29,43,25,68,37,6,43,0.6323529411764706,0.8604651162790697
430,Mississippi Braves,2019,12,AA,4,32,13,17,30,22,7,29,0.43333333333333335,0.7586206896551724
430,Mississippi Braves,2019,12,AA,5,29,16,13,29,14,8,22,0.5517241379310345,0.6363636363636364
430,Mississippi Braves,2019,12,AA,6,38,29,16,45,25,12,37,0.6444444444444445,0.6756756756756757
430,Mississippi Braves,2019,12,AA,7,36,31,10,41,25,5,30,0.7560975609756098,0.8333333333333334
430,Mississippi Braves,2019,12,AA,8,36,30,7,37,24,7,31,0.8108108108108109,0.7741935483870968
430,Mississippi Braves,2019,12,AA,9,2,2,0,2,0,0,0,1.0,
431,Gwinnett Stripers,2019,11,AAA,4,28,9,12,21,11,6,17,0.42857142857142855,0.6470588235294118
431,Gwinnett Stripers,2019,11,AAA,5,29,10,7,17,12,9,21,0.5882352941176471,0.5714285714285714
431,Gwinnett Stripers,2019,11,AAA,6,29,15,6,21,10,10,20,0.7142857142857143,0.5
431,Gwinnett Stripers,2019,11,AAA,7,29,15,7,22,6,6,12,0.6818181818181818,0.5
431,Gwinnett Stripers,2019,11,AAA,8,32,12,6,18,12,15,27,0.6666666666666666,0.4444444444444444
431,Gwinnett Stripers,2019,11,AAA,9,2,2,1,3,0,1,1,0.6666666666666666,0.0
432,Rome Braves,2019,14,A,4,22,10,9,19,10,15,25,0.5263157894736842,0.4
434,Bravos de Leon,2019,11,AAA,4,22,5,9,14,21,8,29,0.35714285714285715,0.7241379310344828
434,Bravos de Leon,2019,11,AAA,5,30,16,6,22,12,3,15,0.7272727272727273,0.8
434,Bravos de Leon,2019,11,AAA,6,23,9,8,17,14,10,24,0.5294117647058824,0.5833333333333334
434,Bravos de Leon,2019,11,AAA,7,45,36,24,60,38,15,53,0.6,0.7169811320754716
434,Bravos de Leon,2019,11,AAA,8,28,18,9,27,18,7,25,0.6666666666666666,0.72
436,Potomac Nationals,2019,13,High-A,4,35,27,11,38,28,10,38,0.7105263157894737,0.7368421052631579
436,Potomac Nationals,2019,13,High-A,5,32,20,7,27,18,10,28,0.7407407407407407,0.6428571428571429
436,Potomac Nationals,2019,13,High-A,6,29,15,8,23,21,14,35,0.6521739130434783,0.6
436,Potomac Nationals,2019,13,High-A,7,42,21,8,29,20,9,29,0.7241379310344828,0.6896551724137931
436,Potomac Nationals,2019,13,High-A,8,28,22,8,30,11,5,16,0.7333333333333333,0.6875
436,Potomac Nationals,2019,13,High-A,9,2,0,0,0,0,0,0,,
437,Lake County Captains,2019,14,A,4,28,55,12,67,25,16,41,0.8208955223880597,0.6097560975609756
440,Springfield Cardinals,2019,12,AA,4,25,15,6,21,24,10,34,0.7142857142857143,0.7058823529411765
440,Springfield Cardinals,2019,12,AA,5,32,22,16,38,25,11,36,0.5789473684210527,0.6944444444444444
440,Springfield Cardinals,2019,12,AA,6,29,15,12,27,48,9,57,0.5555555555555556,0.8421052631578947
440,Springfield Cardinals,2019,12,AA,7,28,19,6,25,13,6,19,0.76,0.6842105263157895
440,Springfield Cardinals,2019,12,AA,8,30,19,11,30,9,6,15,0.6333333333333333,0.6
440,Springfield Cardinals,2019,12,AA,9,2,1,1,2,1,3,4,0.5,0.25
442,Olmecas de Tabasco,2019,11,AAA,4,22,13,7,20,20,11,31,0.65,0.6451612903225806
442,Olmecas de Tabasco,2019,11,AAA,5,27,11,8,19,22,10,32,0.5789473684210527,0.6875
442,Olmecas de Tabasco,2019,11,AAA,6,23,9,11,20,10,10,20,0.45,0.5
442,Olmecas de Tabasco,2019,11,AAA,7,34,36,11,47,25,7,32,0.7659574468085106,0.78125
442,Olmecas de Tabasco,2019,11,AAA,8,25,27,13,40,15,7,22,0.675,0.6818181818181818
443,Peoria Chiefs,2019,14,A,4,24,15,11,26,21,12,33,0.5769230769230769,0.6363636363636364
445,Columbus Clippers,2019,11,AAA,4,30,27,8,35,16,18,34,0.7714285714285715,0.47058823529411764
445,Columbus Clippers,2019,11,AAA,5,29,16,6,22,11,11,22,0.7272727272727273,0.5
445,Columbus Clippers,2019,11,AAA,6,33,25,8,33,26,7,33,0.7575757575757576,0.7878787878787878
445,Columbus Clippers,2019,11,AAA,7,27,15,8,23,10,7,17,0.6521739130434783,0.5882352941176471
445,Columbus Clippers,2019,11,AAA,8,34,21,12,33,15,14,29,0.6363636363636364,0.5172413793103449
445,Columbus Clippers,2019,11,AAA,9,2,0,0,0,0,0,0,,
446,Kane County Cougars,2019,14,A,4,21,16,12,28,12,6,18,0.5714285714285714,0.6666666666666666
447,Algodoneros Union Laguna,2019,11,AAA,4,22,9,10,19,23,6,29,0.47368421052631576,0.7931034482758621
447,Algodoneros Union Laguna,2019,11,AAA,5,30,6,8,14,22,9,31,0.42857142857142855,0.7096774193548387
447,Algodoneros Union Laguna,2019,11,AAA,6,20,8,7,15,16,5,21,0.5333333333333333,0.7619047619047619
447,Algodoneros Union Laguna,2019,11,AAA,7,26,11,11,22,14,8,22,0.5,0.6363636363636364
447,Algodoneros Union Laguna,2019,11,AAA,8,28,15,4,19,14,3,17,0.7894736842105263,0.8235294117647058
448,Hickory Crawdads,2019,14,A,4,28,28,8,36,21,11,32,0.7777777777777778,0.65625
450,Daytona Tortugas,2019,13,High-A,4,28,26,15,41,24,5,29,0.6341463414634146,0.8275862068965517
450,Daytona Tortugas,2019,13,High-A,5,32,22,13,35,26,7,33,0.6285714285714286,0.7878787878787878
450,Daytona Tortugas,2019,13,High-A,6,26,18,8,26,28,8,36,0.6923076923076923,0.7777777777777778
450,Daytona Tortugas,2019,13,High-A,7,36,24,23,47,26,14,40,0.5106382978723404,0.65
450,Daytona Tortugas,2019,13,High-A,8,24,22,7,29,22,5,27,0.7586206896551724,0.8148148148148148
450,Daytona Tortugas,2019,13,High-A,9,1,0,0,0,0,0,0,,
451,Iowa Cubs,2019,11,AAA,4,34,17,10,27,19,10,29,0.6296296296296297,0.6551724137931034
451,Iowa Cubs,2019,11,AAA,5,40,27,12,39,41,13,54,0.6923076923076923,0.7592592592592593
451,Iowa Cubs,2019,11,AAA,6,27,11,11,22,28,8,36,0.5,0.7777777777777778
451,Iowa Cubs,2019,11,AAA,7,26,14,5,19,33,8,41,0.7368421052631579,0.8048780487804879
451,Iowa Cubs,2019,11,AAA,8,29,20,10,30,15,8,23,0.6666666666666666,0.6521739130434783
451,Iowa Cubs,2019,11,AAA,9,2,2,0,2,1,0,1,1.0,1.0
452,Altoona Curve,2019,12,AA,4,32,20,11,31,14,11,25,0.6451612903225806,0.56
452,Altoona Curve,2019,12,AA,5,38,10,15,25,22,14,36,0.4,0.6111111111111112
452,Altoona Curve,2019,12,AA,6,32,32,8,40,15,5,20,0.8,0.75
452,Altoona Curve,2019,12,AA,7,32,24,11,35,29,6,35,0.6857142857142857,0.8285714285714286
452,Altoona Curve,2019,12,AA,8,36,12,13,25,20,12,32,0.48,0.625
452,Altoona Curve,2019,12,AA,9,2,1,1,2,3,0,3,0.5,1.0
456,Great Lakes Loons,2019,14,A,4,22,22,6,28,32,11,43,0.7857142857142857,0.7441860465116279
459,Dayton Dragons,2019,14,A,4,22,23,11,34,26,9,35,0.6764705882352942,0.7428571428571429
463,New Hampshire Fisher Cats,2019,12,AA,4,32,29,11,40,24,11,35,0.725,0.6857142857142857
463,New Hampshire Fisher Cats,2019,12,AA,5,37,27,14,41,12,14,26,0.6585365853658537,0.46153846153846156
463,New Hampshire Fisher Cats,2019,12,AA,6,30,27,18,45,30,13,43,0.6,0.6976744186046512
463,New Hampshire Fisher Cats,2019,12,AA,7,37,18,9,27,20,10,30,0.6666666666666666,0.6666666666666666
463,New Hampshire Fisher Cats,2019,12,AA,8,31,24,10,34,21,14,35,0.7058823529411765,0.6
463,New Hampshire Fisher Cats,2019,12,AA,9,2,3,1,4,1,0,1,0.75,1.0
476,San Jose Giants,2019,13,High-A,4,26,20,9,29,35,15,50,0.6896551724137931,0.7
476,San Jose Giants,2019,13,High-A,5,39,37,9,46,32,6,38,0.8043478260869565,0.8421052631578947
476,San Jose Giants,2019,13,High-A,6,28,21,12,33,30,6,36,0.6363636363636364,0.8333333333333334
476,San Jose Giants,2019,13,High-A,7,26,21,8,29,21,10,31,0.7241379310344828,0.6774193548387096
476,San Jose Giants,2019,13,High-A,8,22,4,2,6,18,4,22,0.6666666666666666,0.8181818181818182
476,San Jose Giants,2019,13,High-A,9,2,0,2,2,0,0,0,0.0,
477,Greensboro Grasshoppers,2019,14,A,4,29,19,12,31,25,10,35,0.6129032258064516,0.7142857142857143
478,Augusta GreenJackets,2019,14,A,4,27,21,6,27,37,12,49,0.7777777777777778,0.7551020408163265
479,Jupiter Hammerheads,2019,13,High-A,4,25,19,4,23,18,14,32,0.8260869565217391,0.5625
479,Jupiter Hammerheads,2019,13,High-A,5,40,22,12,34,37,14,51,0.6470588235294118,0.7254901960784313
479,Jupiter Hammerheads,2019,13,High-A,6,30,12,10,22,25,7,32,0.5454545454545454,0.78125
479,Jupiter Hammerheads,2019,13,High-A,7,41,29,20,49,27,18,45,0.5918367346938775,0.6
479,Jupiter Hammerheads,2019,13,High-A,8,32,18,7,25,27,7,34,0.72,0.7941176470588235
479,Jupiter Hammerheads,2019,13,High-A,9,1,0,0,0,0,0,0,,
481,Lynchburg Hillcats,2019,13,High-A,4,29,20,15,35,22,17,39,0.5714285714285714,0.5641025641025641
481,Lynchburg Hillcats,2019,13,High-A,5,41,22,9,31,28,12,40,0.7096774193548387,0.7
481,Lynchburg Hillcats,2019,13,High-A,6,31,13,10,23,26,10,36,0.5652173913043478,0.7222222222222222
481,Lynchburg Hillcats,2019,13,High-A,7,43,9,7,16,25,13,38,0.5625,0.6578947368421053
481,Lynchburg Hillcats,2019,13,High-A,8,26,17,9,26,23,11,34,0.6538461538461539,0.6764705882352942
481,Lynchburg Hillcats,2019,13,High-A,9,2,2,0,2,2,1,3,1.0,0.6666666666666666
482,Corpus Christi Hooks,2019,12,AA,4,25,30,9,39,15,4,19,0.7692307692307693,0.7894736842105263
482,Corpus Christi Hooks,2019,12,AA,5,29,28,15,43,22,7,29,0.6511627906976745,0.7586206896551724
482,Corpus Christi Hooks,2019,12,AA,6,29,27,5,32,19,12,31,0.84375,0.6129032258064516
482,Corpus Christi Hooks,2019,12,AA,7,28,12,7,19,28,7,35,0.631578947368421,0.8
482,Corpus Christi Hooks,2019,12,AA,8,30,32,14,46,21,14,35,0.6956521739130435,0.6
482,Corpus Christi Hooks,2019,12,AA,9,2,0,1,1,0,0,0,0.0,
484,Indianapolis Indians,2019,11,AAA,4,26,23,12,35,24,7,31,0.6571428571428571,0.7741935483870968
484,Indianapolis Indians,2019,11,AAA,5,29,18,6,24,18,8,26,0.75,0.6923076923076923
484,Indianapolis Indians,2019,11,AAA,6,32,11,14,25,30,18,48,0.44,0.625
484,Indianapolis Indians,2019,11,AAA,7,29,10,9,19,16,10,26,0.5263157894736842,0.6153846153846154
484,Indianapolis Indians,2019,11,AAA,8,37,10,3,13,30,14,44,0.7692307692307693,0.6818181818181818
484,Indianapolis Indians,2019,11,AAA,9,2,0,0,0,4,0,4,,1.0
485,Down East Wood Ducks,2019,13,High-A,4,29,35,22,57,28,29,57,0.6140350877192983,0.49122807017543857
485,Down East Wood Ducks,2019,13,High-A,5,35,55,16,71,18,9,27,0.7746478873239436,0.6666666666666666
485,Down East Wood Ducks,2019,13,High-A,6,29,31,20,51,23,12,35,0.6078431372549019,0.6571428571428571
485,Down East Wood Ducks,2019,13,High-A,7,30,28,16,44,10,13,23,0.6363636363636364,0.43478260869565216
485,Down East Wood Ducks,2019,13,High-A,8,29,20,11,31,6,7,13,0.6451612903225806,0.46153846153846156
485,Down East Wood Ducks,2019,13,High-A,9,2,2,1,3,3,2,5,0.6666666666666666,0.6
487,Kannapolis Intimidators,2019,14,A,4,23,22,4,26,19,3,22,0.8461538461538461,0.8636363636363636
491,Lancaster JetHawks,2019,13,High-A,4,29,34,14,48,27,15,42,0.7083333333333334,0.6428571428571429
491,Lancaster JetHawks,2019,13,High-A,5,35,38,19,57,22,11,33,0.6666666666666666,0.6666666666666666
491,Lancaster JetHawks,2019,13,High-A,6,26,32,13,45,16,9,25,0.7111111111111111,0.64
491,Lancaster JetHawks,2019,13,High-A,7,27,23,9,32,14,9,23,0.71875,0.6086956521739131
491,Lancaster JetHawks,2019,13,High-A,8,23,29,11,40,12,7,19,0.725,0.631578947368421
491,Lancaster JetHawks,2019,13,High-A,9,2,1,1,2,1,0,1,0.5,1.0
492,Cedar Rapids Kernels,2019,14,A,4,25,16,8,24,19,10,29,0.6666666666666666,0.6551724137931034
493,Frederick Keys,2019,13,High-A,4,36,22,7,29,28,15,43,0.7586206896551724,0.6511627906976745
493,Frederick Keys,2019,13,High-A,5,44,16,9,25,25,3,28,0.64,0.8928571428571429
493,Frederick Keys,2019,13,High-A,6,33,15,3,18,25,11,36,0.8333333333333334,0.6944444444444444
493,Frederick Keys,2019,13,High-A,7,42,14,8,22,9,3,12,0.6363636363636364,0.75
493,Frederick Keys,2019,13,High-A,8,31,5,6,11,27,11,38,0.45454545454545453,0.7105263157894737
493,Frederick Keys,2019,13,High-A,9,2,0,0,0,0,0,0,,
494,Charlotte Knights,2019,11,AAA,4,32,12,3,15,21,10,31,0.8,0.6774193548387096
494,Charlotte Knights,2019,11,AAA,5,33,25,7,32,20,5,25,0.78125,0.8
494,Charlotte Knights,2019,11,AAA,6,40,26,8,34,26,11,37,0.7647058823529411,0.7027027027027027
494,Charlotte Knights,2019,11,AAA,7,30,21,8,29,19,11,30,0.7241379310344828,0.6333333333333333
494,Charlotte Knights,2019,11,AAA,8,33,8,11,19,11,4,15,0.42105263157894735,0.7333333333333333
494,Charlotte Knights,2019,11,AAA,9,2,1,0,1,0,1,1,1.0,0.0
495,Lexington Legends,2019,14,A,4,21,26,6,32,8,9,17,0.8125,0.47058823529411764
496,Leones de Yucatan,2019,11,AAA,4,22,26,7,33,8,11,19,0.7878787878787878,0.42105263157894735
496,Leones de Yucatan,2019,11,AAA,5,26,20,11,31,9,8,17,0.6451612903225806,0.5294117647058824
496,Leones de Yucatan,2019,11,AAA,6,32,17,9,26,9,5,14,0.6538461538461539,0.6428571428571429
496,Leones de Yucatan,2019,11,AAA,7,27,25,10,35,10,5,15,0.7142857142857143,0.6666666666666666
496,Leones de Yucatan,2019,11,AAA,8,27,18,10,28,14,9,23,0.6428571428571429,0.6086956521739131
498,Chattanooga Lookouts,2019,12,AA,4,34,25,9,34,32,8,40,0.7352941176470589,0.8
498,Chattanooga Lookouts,2019,12,AA,5,35,34,15,49,19,14,33,0.6938775510204082,0.5757575757575758
498,Chattanooga Lookouts,2019,12,AA,6,29,20,7,27,31,13,44,0.7407407407407407,0.7045454545454546
498,Chattanooga Lookouts,2019,12,AA,7,35,12,5,17,21,6,27,0.7058823529411765,0.7777777777777778
498,Chattanooga Lookouts,2019,12,AA,8,34,10,3,13,28,14,42,0.7692307692307693,0.6666666666666666
498,Chattanooga Lookouts,2019,12,AA,9,2,0,0,0,2,0,2,,1.0
499,Lansing Lugnuts,2019,14,A,4,22,25,12,37,22,6,28,0.6756756756756757,0.7857142857142857
500,Clinton LumberKings,2019,14,A,4,24,20,6,26,22,14,36,0.7692307692307693,0.6111111111111112
502,Saraperos de Saltillo,2019,11,AAA,4,22,17,10,27,24,7,31,0.6296296296296297,0.7741935483870968
502,Saraperos de Saltillo,2019,11,AAA,5,33,12,12,24,22,8,30,0.5,0.7333333333333333
502,Saraperos de Saltillo,2019,11,AAA,6,23,12,4,16,10,6,16,0.75,0.625
502,Saraperos de Saltillo,2019,11,AAA,7,29,22,9,31,16,11,27,0.7096774193548387,0.5925925925925926
502,Saraperos de Saltillo,2019,11,AAA,8,33,10,4,14,23,12,35,0.7142857142857143,0.6571428571428571
503,Florida Fire Frogs,2019,13,High-A,4,28,12,12,24,36,18,54,0.5,0.6666666666666666
503,Florida Fire Frogs,2019,13,High-A,5,43,8,12,20,47,19,66,0.4,0.7121212121212122
503,Florida Fire Frogs,2019,13,High-A,6,32,14,7,21,25,7,32,0.6666666666666666,0.78125
503,Florida Fire Frogs,2019,13,High-A,7,41,23,9,32,31,14,45,0.71875,0.6888888888888889
503,Florida Fire Frogs,2019,13,High-A,8,39,5,2,7,30,16,46,0.7142857142857143,0.6521739130434783
503,Florida Fire Frogs,2019,13,High-A,9,1,0,0,0,0,0,0,,
505,Binghamton Rumble Ponies,2019,12,AA,4,50,39,16,55,47,16,63,0.7090909090909091,0.746031746031746
505,Binghamton Rumble Ponies,2019,12,AA,5,38,41,16,57,18,19,37,0.7192982456140351,0.4864864864864865
505,Binghamton Rumble Ponies,2019,12,AA,6,43,24,8,32,51,10,61,0.75,0.8360655737704918
505,Binghamton Rumble Ponies,2019,12,AA,7,41,28,15,43,33,16,49,0.6511627906976745,0.673469387755102
505,Binghamton Rumble Ponies,2019,12,AA,8,38,22,15,37,33,11,44,0.5945945945945946,0.75
505,Binghamton Rumble Ponies,2019,12,AA,9,2,1,2,3,2,0,2,0.3333333333333333,1.0
507,St. Lucie Mets,2019,13,High-A,4,28,23,17,40,13,12,25,0.575,0.52
507,St. Lucie Mets,2019,13,High-A,5,46,53,25,78,17,27,44,0.6794871794871795,0.38636363636363635
507,St. Lucie Mets,2019,13,High-A,6,29,24,12,36,27,16,43,0.6666666666666666,0.627906976744186
507,St. Lucie Mets,2019,13,High-A,7,33,30,11,41,21,13,34,0.7317073170731707,0.6176470588235294
507,St. Lucie Mets,2019,13,High-A,8,26,25,15,40,24,7,31,0.625,0.7741935483870968
507,St. Lucie Mets,2019,13,High-A,9,1,0,0,0,0,0,0,,
509,Fort Myers Miracle,2019,13,High-A,4,25,18,8,26,11,14,25,0.6923076923076923,0.44
509,Fort Myers Miracle,2019,13,High-A,5,44,22,18,40,33,15,48,0.55,0.6875
509,Fort Myers Miracle,2019,13,High-A,6,34,21,1,22,21,16,37,0.9545454545454546,0.5675675675675675
509,Fort Myers Miracle,2019,13,High-A,7,35,18,8,26,29,7,36,0.6923076923076923,0.8055555555555556
509,Fort Myers Miracle,2019,13,High-A,8,36,22,9,31,25,15,40,0.7096774193548387,0.625
510,San Antonio Missions,2019,11,AAA,4,34,25,9,34,16,8,24,0.7352941176470589,0.6666666666666666
510,San Antonio Missions,2019,11,AAA,5,37,30,9,39,28,4,32,0.7692307692307693,0.875
510,San Antonio Missions,2019,11,AAA,6,30,23,10,33,26,3,29,0.696969696969697,0.896551724137931
510,San Antonio Missions,2019,11,AAA,7,26,27,8,35,19,5,24,0.7714285714285715,0.7916666666666666
510,San Antonio Missions,2019,11,AAA,8,29,24,3,27,19,4,23,0.8888888888888888,0.8260869565217391
510,San Antonio Missions,2019,11,AAA,9,2,0,0,0,2,1,3,,0.6666666666666666
512,Toledo Mud Hens,2019,11,AAA,4,26,24,12,36,23,10,33,0.6666666666666666,0.696969696969697
512,Toledo Mud Hens,2019,11,AAA,5,32,19,14,33,29,8,37,0.5757575757575758,0.7837837837837838
512,Toledo Mud Hens,2019,11,AAA,6,34,34,14,48,16,8,24,0.7083333333333334,0.6666666666666666
512,Toledo Mud Hens,2019,11,AAA,7,29,37,9,46,11,8,19,0.8043478260869565,0.5789473684210527
512,Toledo Mud Hens,2019,11,AAA,8,32,17,5,22,15,7,22,0.7727272727272727,0.6818181818181818
512,Toledo Mud Hens,2019,11,AAA,9,2,0,0,0,0,0,0,,
515,Modesto Nuts,2019,13,High-A,4,29,24,8,32,40,19,59,0.75,0.6779661016949152
515,Modesto Nuts,2019,13,High-A,5,29,15,7,22,32,21,53,0.6818181818181818,0.6037735849056604
515,Modesto Nuts,2019,13,High-A,6,26,22,11,33,19,13,32,0.6666666666666666,0.59375
515,Modesto Nuts,2019,13,High-A,7,26,22,8,30,28,13,41,0.7333333333333333,0.6829268292682927
515,Modesto Nuts,2019,13,High-A,8,23,10,7,17,22,10,32,0.5882352941176471,0.6875
515,Modesto Nuts,2019,13,High-A,9,2,2,0,2,2,3,5,1.0,0.4
516,Visalia Rawhide,2019,13,High-A,4,29,51,25,76,32,12,44,0.6710526315789473,0.7272727272727273
516,Visalia Rawhide,2019,13,High-A,5,36,34,18,52,10,7,17,0.6538461538461539,0.5882352941176471
516,Visalia Rawhide,2019,13,High-A,6,28,25,11,36,18,13,31,0.6944444444444444,0.5806451612903226
516,Visalia Rawhide,2019,13,High-A,7,27,21,7,28,20,8,28,0.75,0.7142857142857143
516,Visalia Rawhide,2019,13,High-A,8,23,28,14,42,8,7,15,0.6666666666666666,0.5333333333333333
516,Visalia Rawhide,2019,13,High-A,9,2,2,3,5,2,0,2,0.4,1.0
520,Pericos de Puebla,2019,11,AAA,4,22,13,8,21,13,9,22,0.6190476190476191,0.5909090909090909
520,Pericos de Puebla,2019,11,AAA,5,27,15,8,23,16,7,23,0.6521739130434783,0.6956521739130435
520,Pericos de Puebla,2019,11,AAA,6,26,8,13,21,16,8,24,0.38095238095238093,0.6666666666666666
520,Pericos de Puebla,2019,11,AAA,7,37,6,5,11,20,17,37,0.5454545454545454,0.5405405405405406
520,Pericos de Puebla,2019,11,AAA,8,28,3,7,10,18,14,32,0.3,0.5625
521,Myrtle Beach Pelicans,2019,13,High-A,4,29,30,12,42,36,23,59,0.7142857142857143,0.6101694915254238
521,Myrtle Beach Pelicans,2019,13,High-A,5,29,31,18,49,29,12,41,0.6326530612244898,0.7073170731707317
521,Myrtle Beach Pelicans,2019,13,High-A,6,34,28,16,44,38,14,52,0.6363636363636364,0.7307692307692307
521,Myrtle Beach Pelicans,2019,13,High-A,7,36,29,21,50,16,13,29,0.58,0.5517241379310345
521,Myrtle Beach Pelicans,2019,13,High-A,8,29,29,14,43,22,9,31,0.6744186046511628,0.7096774193548387
521,Myrtle Beach Pelicans,2019,13,High-A,9,2,0,1,1,2,0,2,0.0,1.0
522,Reading Fightin Phils,2019,12,AA,4,30,22,10,32,15,10,25,0.6875,0.6
522,Reading Fightin Phils,2019,12,AA,5,44,34,20,54,25,13,38,0.6296296296296297,0.6578947368421053
522,Reading Fightin Phils,2019,12,AA,6,38,31,23,54,29,22,51,0.5740740740740741,0.5686274509803921
522,Reading Fightin Phils,2019,12,AA,7,44,36,17,53,30,13,43,0.6792452830188679,0.6976744186046512
522,Reading Fightin Phils,2019,12,AA,8,28,17,9,26,18,8,26,0.6538461538461539,0.6923076923076923
522,Reading Fightin Phils,2019,12,AA,9,2,4,0,4,0,0,0,1.0,
523,Piratas de Campeche,2019,11,AAA,4,22,10,2,12,10,11,21,0.8333333333333334,0.47619047619047616
523,Piratas de Campeche,2019,11,AAA,5,26,16,8,24,21,8,29,0.6666666666666666,0.7241379310344828
523,Piratas de Campeche,2019,11,AAA,6,35,9,7,16,17,13,30,0.5625,0.5666666666666667
523,Piratas de Campeche,2019,11,AAA,7,33,37,5,42,25,11,36,0.8809523809523809,0.6944444444444444
523,Piratas de Campeche,2019,11,AAA,8,35,12,17,29,21,12,33,0.41379310344827586,0.6363636363636364
524,Stockton Ports,2019,13,High-A,4,26,20,10,30,24,6,30,0.6666666666666666,0.8
524,Stockton Ports,2019,13,High-A,5,38,16,8,24,26,3,29,0.6666666666666666,0.896551724137931
524,Stockton Ports,2019,13,High-A,6,26,22,9,31,25,11,36,0.7096774193548387,0.6944444444444444
524,Stockton Ports,2019,13,High-A,7,27,17,7,24,22,9,31,0.7083333333333334,0.7096774193548387
524,Stockton Ports,2019,13,High-A,8,23,17,6,23,10,11,21,0.7391304347826086,0.47619047619047616
524,Stockton Ports,2019,13,High-A,9,2,0,0,0,0,2,2,,0.0
525,West Virginia Power,2019,14,A,4,27,14,5,19,25,9,34,0.7368421052631579,0.7352941176470589
526,Rancho Cucamonga Quakes,2019,13,High-A,4,26,54,17,71,27,9,36,0.7605633802816901,0.75
526,Rancho Cucamonga Quakes,2019,13,High-A,5,32,28,13,41,30,10,40,0.6829268292682927,0.75
526,Rancho Cucamonga Quakes,2019,13,High-A,6,26,35,12,47,32,10,42,0.7446808510638298,0.7619047619047619
526,Rancho Cucamonga Quakes,2019,13,High-A,7,27,29,21,50,19,10,29,0.58,0.6551724137931034
526,Rancho Cucamonga Quakes,2019,13,High-A,8,23,23,13,36,34,8,42,0.6388888888888888,0.8095238095238095
526,Rancho Cucamonga Quakes,2019,13,High-A,9,2,2,1,3,4,1,5,0.6666666666666666,0.8
528,Rieleros de Aguascalientes,2019,11,AAA,4,25,19,6,25,12,3,15,0.76,0.8
528,Rieleros de Aguascalientes,2019,11,AAA,5,27,14,11,25,16,6,22,0.56,0.7272727272727273
528,Rieleros de Aguascalientes,2019,11,AAA,6,23,19,5,24,17,7,24,0.7916666666666666,0.7083333333333334
528,Rieleros de Aguascalientes,2019,11,AAA,7,34,22,7,29,48,6,54,0.7586206896551724,0.8888888888888888
528,Rieleros de Aguascalientes,2019,11,AAA,8,28,15,6,21,17,4,21,0.7142857142857143,0.8095238095238095
529,Tacoma Rainiers,2019,11,AAA,4,26,17,11,28,14,6,20,0.6071428571428571,0.7
529,Tacoma Rainiers,2019,11,AAA,5,33,47,9,56,17,6,23,0.8392857142857143,0.7391304347826086
529,Tacoma Rainiers,2019,11,AAA,6,27,31,8,39,19,3,22,0.7948717948717948,0.8636363636363636
529,Tacoma Rainiers,2019,11,AAA,7,29,17,9,26,21,5,26,0.6538461538461539,0.8076923076923077
529,Tacoma Rainiers,2019,11,AAA,8,29,11,1,12,15,2,17,0.9166666666666666,0.8823529411764706
529,Tacoma Rainiers,2019,11,AAA,9,2,0,0,0,3,0,3,,1.0
531,Scranton/Wilkes-Barre RailRiders,2019,11,AAA,4,36,30,3,33,45,14,59,0.9090909090909091,0.7627118644067796
531,Scranton/Wilkes-Barre RailRiders,2019,11,AAA,5,35,20,12,32,27,8,35,0.625,0.7714285714285715
531,Scranton/Wilkes-Barre RailRiders,2019,11,AAA,6,36,16,7,23,26,16,42,0.6956521739130435,0.6190476190476191
531,Scranton/Wilkes-Barre RailRiders,2019,11,AAA,7,32,12,12,24,12,7,19,0.5,0.631578947368421
531,Scranton/Wilkes-Barre RailRiders,2019,11,AAA,8,32,13,10,23,16,9,25,0.5652173913043478,0.64
531,Scranton/Wilkes-Barre RailRiders,2019,11,AAA,9,3,4,0,4,5,1,6,1.0,0.8333333333333334
532,Diablos Rojos del Mexico,2019,11,AAA,4,22,11,6,17,10,6,16,0.6470588235294118,0.625
532,Diablos Rojos del Mexico,2019,11,AAA,5,33,12,7,19,13,15,28,0.631578947368421,0.4642857142857143
532,Diablos Rojos del Mexico,2019,11,AAA,6,20,11,6,17,2,11,13,0.6470588235294118,0.15384615384615385
532,Diablos Rojos del Mexico,2019,11,AAA,7,26,13,7,20,9,12,21,0.65,0.42857142857142855
532,Diablos Rojos del Mexico,2019,11,AAA,8,33,8,3,11,9,19,28,0.7272727272727273,0.32142857142857145
533,Pawtucket Red Sox,2019,11,AAA,4,46,19,13,32,35,15,50,0.59375,0.7
533,Pawtucket Red Sox,2019,11,AAA,5,44,25,4,29,31,5,36,0.8620689655172413,0.8611111111111112
533,Pawtucket Red Sox,2019,11,AAA,6,37,10,17,27,43,6,49,0.37037037037037035,0.8775510204081632
533,Pawtucket Red Sox,2019,11,AAA,7,32,23,11,34,10,11,21,0.6764705882352942,0.47619047619047616
533,Pawtucket Red Sox,2019,11,AAA,8,34,8,12,20,19,18,37,0.4,0.5135135135135135
533,Pawtucket Red Sox,2019,11,AAA,9,2,0,1,1,0,3,3,0.0,0.0
534,Rochester Red Wings,2019,11,AAA,4,34,10,3,13,29,15,44,0.7692307692307693,0.6590909090909091
534,Rochester Red Wings,2019,11,AAA,5,39,33,5,38,27,6,33,0.868421052631579,0.8181818181818182
534,Rochester Red Wings,2019,11,AAA,6,38,26,4,30,18,12,30,0.8666666666666667,0.6
534,Rochester Red Wings,2019,11,AAA,7,34,13,2,15,11,9,20,0.8666666666666667,0.55
534,Rochester Red Wings,2019,11,AAA,8,29,17,5,22,22,6,28,0.7727272727272727,0.7857142857142857
534,Rochester Red Wings,2019,11,AAA,9,2,0,0,0,3,0,3,,1.0
536,Tecos de los Dos Laredos,2019,11,AAA,4,22,17,10,27,13,9,22,0.6296296296296297,0.5909090909090909
536,Tecos de los Dos Laredos,2019,11,AAA,5,27,26,10,36,8,10,18,0.7222222222222222,0.4444444444444444
536,Tecos de los Dos Laredos,2019,11,AAA,6,23,18,6,24,14,6,20,0.75,0.7
536,Tecos de los Dos Laredos,2019,11,AAA,7,34,18,18,36,37,16,53,0.5,0.6981132075471698
536,Tecos de los Dos Laredos,2019,11,AAA,8,25,6,7,13,12,9,21,0.46153846153846156,0.5714285714285714
538,Hartford Yard Goats,2019,12,AA,4,32,15,12,27,15,12,27,0.5555555555555556,0.5555555555555556
538,Hartford Yard Goats,2019,12,AA,5,31,25,15,40,18,12,30,0.625,0.6
538,Hartford Yard Goats,2019,12,AA,6,30,20,16,36,17,15,32,0.5555555555555556,0.53125
538,Hartford Yard Goats,2019,12,AA,7,30,38,11,49,14,11,25,0.7755102040816326,0.56
538,Hartford Yard Goats,2019,12,AA,8,33,29,13,42,19,14,33,0.6904761904761905,0.5757575757575758
538,Hartford Yard Goats,2019,12,AA,9,2,2,0,2,1,2,3,1.0,0.3333333333333333
540,Frisco RoughRiders,2019,12,AA,4,28,10,11,21,30,6,36,0.47619047619047616,0.8333333333333334
540,Frisco RoughRiders,2019,12,AA,5,32,14,6,20,24,13,37,0.7,0.6486486486486487
540,Frisco RoughRiders,2019,12,AA,6,30,17,5,22,33,9,42,0.7727272727272727,0.7857142857142857
540,Frisco RoughRiders,2019,12,AA,7,28,26,11,37,18,4,22,0.7027027027027027,0.8181818181818182
540,Frisco RoughRiders,2019,12,AA,8,32,11,8,19,31,9,40,0.5789473684210527,0.775
540,Frisco RoughRiders,2019,12,AA,9,2,1,0,1,3,0,3,1.0,1.0
541,Omaha Storm Chasers,2019,11,AAA,4,36,34,9,43,38,6,44,0.7906976744186046,0.8636363636363636
541,Omaha Storm Chasers,2019,11,AAA,5,35,32,13,45,29,7,36,0.7111111111111111,0.8055555555555556
541,Omaha Storm Chasers,2019,11,AAA,6,30,33,7,40,16,8,24,0.825,0.6666666666666666
541,Omaha Storm Chasers,2019,11,AAA,7,26,22,7,29,20,11,31,0.7586206896551724,0.6451612903225806
541,Omaha Storm Chasers,2019,11,AAA,8,29,42,12,54,10,9,19,0.7777777777777778,0.5263157894736842
541,Omaha Storm Chasers,2019,11,AAA,9,2,2,0,2,2,1,3,1.0,0.6666666666666666
546,Portland Sea Dogs,2019,12,AA,4,43,32,13,45,38,18,56,0.7111111111111111,0.6785714285714286
546,Portland Sea Dogs,2019,12,AA,5,39,27,12,39,51,20,71,0.6923076923076923,0.7183098591549296
546,Portland Sea Dogs,2019,12,AA,6,41,45,14,59,48,12,60,0.7627118644067796,0.8
546,Portland Sea Dogs,2019,12,AA,7,38,36,7,43,18,11,29,0.8372093023255814,0.6206896551724138
546,Portland Sea Dogs,2019,12,AA,8,35,37,6,43,32,11,43,0.8604651162790697,0.7441860465116279
546,Portland Sea Dogs,2019,12,AA,9,2,1,0,1,3,1,4,1.0,0.75
547,Harrisburg Senators,2019,12,AA,4,33,14,9,23,17,9,26,0.6086956521739131,0.6538461538461539
547,Harrisburg Senators,2019,12,AA,5,35,16,7,23,24,6,30,0.6956521739130435,0.8
547,Harrisburg Senators,2019,12,AA,6,27,5,7,12,14,4,18,0.4166666666666667,0.7777777777777778
547,Harrisburg Senators,2019,12,AA,7,30,25,10,35,29,8,37,0.7142857142857143,0.7837837837837838
547,Harrisburg Senators,2019,12,AA,8,37,17,5,22,24,12,36,0.7727272727272727,0.6666666666666666
547,Harrisburg Senators,2019,12,AA,9,2,3,0,3,1,1,2,1.0,0.5
548,Delmarva Shorebirds,2019,14,A,4,27,22,9,31,35,8,43,0.7096774193548387,0.813953488372093
550,South Bend Cubs,2019,14,A,4,25,24,13,37,37,16,53,0.6486486486486487,0.6981132075471698
552,Syracuse Mets,2019,11,AAA,4,39,57,18,75,14,11,25,0.76,0.56
552,Syracuse Mets,2019,11,AAA,5,31,30,16,46,12,13,25,0.6521739130434783,0.48
552,Syracuse Mets,2019,11,AAA,6,30,17,10,27,7,6,13,0.6296296296296297,0.5384615384615384
552,Syracuse Mets,2019,11,AAA,7,27,13,9,22,21,14,35,0.5909090909090909,0.6
552,Syracuse Mets,2019,11,AAA,8,35,39,8,47,8,6,14,0.8297872340425532,0.5714285714285714
552,Syracuse Mets,2019,11,AAA,9,3,6,0,6,1,0,1,1.0,1.0
553,Tennessee Smokies,2019,12,AA,4,29,30,6,36,24,6,30,0.8333333333333334,0.8
553,Tennessee Smokies,2019,12,AA,5,34,21,14,35,18,15,33,0.6,0.5454545454545454
553,Tennessee Smokies,2019,12,AA,6,30,29,11,40,37,16,53,0.725,0.6981132075471698
553,Tennessee Smokies,2019,12,AA,7,32,35,11,46,48,24,72,0.7608695652173914,0.6666666666666666
553,Tennessee Smokies,2019,12,AA,8,34,24,11,35,21,8,29,0.6857142857142857,0.7241379310344828
553,Tennessee Smokies,2019,12,AA,9,2,0,2,2,0,1,1,0.0,0.0
554,Beloit Snappers,2019,14,A,4,25,22,14,36,37,4,41,0.6111111111111112,0.9024390243902439
556,Nashville Sounds,2019,11,AAA,4,33,15,10,25,32,7,39,0.6,0.8205128205128205
556,Nashville Sounds,2019,11,AAA,5,36,32,14,46,33,13,46,0.6956521739130435,0.717391304347826
556,Nashville Sounds,2019,11,AAA,6,30,14,13,27,28,11,39,0.5185185185185185,0.717948717948718
556,Nashville Sounds,2019,11,AAA,7,26,19,7,26,22,7,29,0.7307692307692307,0.7586206896551724
556,Nashville Sounds,2019,11,AAA,8,31,11,9,20,15,11,26,0.55,0.5769230769230769
556,Nashville Sounds,2019,11,AAA,9,2,2,1,3,0,0,0,0.6666666666666666,
560,Acereros del Norte,2019,11,AAA,4,22,12,4,16,15,7,22,0.75,0.6818181818181818
560,Acereros del Norte,2019,11,AAA,5,27,17,7,24,18,6,24,0.7083333333333334,0.75
560,Acereros del Norte,2019,11,AAA,6,20,10,5,15,22,7,29,0.6666666666666666,0.7586206896551724
560,Acereros del Norte,2019,11,AAA,7,26,14,8,22,15,10,25,0.6363636363636364,0.6
560,Acereros del Norte,2019,11,AAA,8,25,11,3,14,7,11,18,0.7857142857142857,0.3888888888888889
561,Salt Lake Bees,2019,11,AAA,4,35,12,9,21,10,10,20,0.5714285714285714,0.5
561,Salt Lake Bees,2019,11,AAA,5,36,10,9,19,25,8,33,0.5263157894736842,0.7575757575757576
561,Salt Lake Bees,2019,11,AAA,6,33,10,7,17,26,11,37,0.5882352941176471,0.7027027027027027
561,Salt Lake Bees,2019,11,AAA,7,34,18,14,32,15,9,24,0.5625,0.625
561,Salt Lake Bees,2019,11,AAA,8,29,10,6,16,18,13,31,0.625,0.5806451612903226
561,Salt Lake Bees,2019,11,AAA,9,2,1,1,2,0,1,1,0.5,0.0
562,Sultanes de Monterrey,2019,11,AAA,4,22,12,3,15,13,4,17,0.8,0.7647058823529411
562,Sultanes de Monterrey,2019,11,AAA,5,30,16,7,23,1,11,12,0.6956521739130435,0.08333333333333333
562,Sultanes de Monterrey,2019,11,AAA,6,23,12,7,19,11,8,19,0.631578947368421,0.5789473684210527
562,Sultanes de Monterrey,2019,11,AAA,7,29,18,7,25,16,8,24,0.72,0.6666666666666666
562,Sultanes de Monterrey,2019,11,AAA,8,25,15,6,21,11,5,16,0.7142857142857143,0.6875
563,Hagerstown Suns,2019,14,A,4,27,39,9,48,17,24,41,0.8125,0.4146341463414634
564,Jacksonville Jumbo Shrimp,2019,12,AA,4,28,24,9,33,26,17,43,0.7272727272727273,0.6046511627906976
564,Jacksonville Jumbo Shrimp,2019,12,AA,5,32,28,13,41,15,15,30,0.6829268292682927,0.5
564,Jacksonville Jumbo Shrimp,2019,12,AA,6,30,23,7,30,20,17,37,0.7666666666666667,0.5405405405405406
564,Jacksonville Jumbo Shrimp,2019,12,AA,7,36,27,8,35,26,10,36,0.7714285714285715,0.7222222222222222
564,Jacksonville Jumbo Shrimp,2019,12,AA,8,30,19,6,25,13,5,18,0.76,0.7222222222222222
564,Jacksonville Jumbo Shrimp,2019,12,AA,9,2,0,0,0,0,0,0,,
565,Quad Cities River Bandits,2019,14,A,4,27,39,18,57,22,5,27,0.6842105263157895,0.8148148148148148
566,Clearwater Threshers,2019,13,High-A,4,25,22,17,39,25,15,40,0.5641025641025641,0.625
566,Clearwater Threshers,2019,13,High-A,5,35,19,8,27,24,14,38,0.7037037037037037,0.631578947368421
566,Clearwater Threshers,2019,13,High-A,6,26,22,7,29,20,10,30,0.7586206896551724,0.6666666666666666
566,Clearwater Threshers,2019,13,High-A,7,44,21,15,36,17,9,26,0.5833333333333334,0.6538461538461539
566,Clearwater Threshers,2019,13,High-A,8,30,19,11,30,11,4,15,0.6333333333333333,0.7333333333333333
567,Trenton Thunder,2019,12,AA,4,33,33,5,38,22,15,37,0.868421052631579,0.5945945945945946
567,Trenton Thunder,2019,12,AA,5,42,28,22,50,37,12,49,0.56,0.7551020408163265
567,Trenton Thunder,2019,12,AA,6,29,27,9,36,24,10,34,0.75,0.7058823529411765
567,Trenton Thunder,2019,12,AA,7,37,20,6,26,40,9,49,0.7692307692307693,0.8163265306122449
567,Trenton Thunder,2019,12,AA,8,35,19,16,35,17,12,29,0.5428571428571428,0.5862068965517241
567,Trenton Thunder,2019,12,AA,9,2,0,0,0,4,0,4,,1.0
568,Norfolk Tides,2019,11,AAA,4,32,15,8,23,17,6,23,0.6521739130434783,0.7391304347826086
568,Norfolk Tides,2019,11,AAA,5,34,22,5,27,31,9,40,0.8148148148148148,0.775
568,Norfolk Tides,2019,11,AAA,6,33,24,11,35,26,15,41,0.6857142857142857,0.6341463414634146
568,Norfolk Tides,2019,11,AAA,7,30,13,4,17,14,6,20,0.7647058823529411,0.7
568,Norfolk Tides,2019,11,AAA,8,38,16,12,28,18,4,22,0.5714285714285714,0.8181818181818182
568,Norfolk Tides,2019,11,AAA,9,2,0,1,1,1,0,1,0.0,1.0
569,Tigres de Quintana Roo,2019,11,AAA,4,22,9,8,17,8,5,13,0.5294117647058824,0.6153846153846154
569,Tigres de Quintana Roo,2019,11,AAA,5,30,13,8,21,19,6,25,0.6190476190476191,0.76
569,Tigres de Quintana Roo,2019,11,AAA,6,20,10,9,19,12,7,19,0.5263157894736842,0.631578947368421
569,Tigres de Quintana Roo,2019,11,AAA,7,26,17,3,20,9,8,17,0.85,0.5294117647058824
569,Tigres de Quintana Roo,2019,11,AAA,8,33,44,7,51,14,15,29,0.8627450980392157,0.4827586206896552
570,Lakeland Flying Tigers,2019,13,High-A,4,26,31,9,40,27,6,33,0.775,0.8181818181818182
570,Lakeland Flying Tigers,2019,13,High-A,5,34,37,9,46,27,7,34,0.8043478260869565,0.7941176470588235
570,Lakeland Flying Tigers,2019,13,High-A,6,29,36,18,54,20,8,28,0.6666666666666666,0.7142857142857143
570,Lakeland Flying Tigers,2019,13,High-A,7,47,52,13,65,22,18,40,0.8,0.55
570,Lakeland Flying Tigers,2019,13,High-A,8,34,30,12,42,14,10,24,0.7142857142857143,0.5833333333333334
570,Lakeland Flying Tigers,2019,13,High-A,9,1,0,0,0,0,0,0,,
572,Wisconsin Timber Rattlers,2019,14,A,4,27,29,8,37,23,17,40,0.7837837837837838,0.575
573,Asheville Tourists,2019,14,A,4,32,29,15,44,28,11,39,0.6590909090909091,0.717948717948718
574,Arkansas Travelers,2019,12,AA,4,26,28,9,37,17,7,24,0.7567567567567568,0.7083333333333334
574,Arkansas Travelers,2019,12,AA,5,40,24,4,28,51,7,58,0.8571428571428571,0.8793103448275862
574,Arkansas Travelers,2019,12,AA,6,29,14,14,28,31,7,38,0.5,0.8157894736842105
574,Arkansas Travelers,2019,12,AA,7,28,16,4,20,29,9,38,0.8,0.7631578947368421
574,Arkansas Travelers,2019,12,AA,8,30,20,9,29,34,9,43,0.6896551724137931,0.7906976744186046
574,Arkansas Travelers,2019,12,AA,9,2,1,0,1,1,1,2,1.0,0.5
579,Guerreros de Oaxaca,2019,11,AAA,4,22,30,14,44,14,3,17,0.6818181818181818,0.8235294117647058
579,Guerreros de Oaxaca,2019,11,AAA,5,27,23,12,35,17,14,31,0.6571428571428571,0.5483870967741935
579,Guerreros de Oaxaca,2019,11,AAA,6,20,22,8,30,3,7,10,0.7333333333333333,0.3
579,Guerreros de Oaxaca,2019,11,AAA,7,29,42,12,54,23,8,31,0.7777777777777778,0.7419354838709677
579,Guerreros de Oaxaca,2019,11,AAA,8,39,21,22,43,45,6,51,0.4883720930232558,0.8823529411764706
580,Winston-Salem Dash,2019,13,High-A,4,32,33,12,45,28,17,45,0.7333333333333333,0.6222222222222222
580,Winston-Salem Dash,2019,13,High-A,5,36,26,8,34,27,10,37,0.7647058823529411,0.7297297297297297
580,Winston-Salem Dash,2019,13,High-A,6,39,18,9,27,15,9,24,0.6666666666666666,0.625
580,Winston-Salem Dash,2019,13,High-A,7,28,5,15,20,24,10,34,0.25,0.7058823529411765
580,Winston-Salem Dash,2019,13,High-A,8,23,15,6,21,5,10,15,0.7142857142857143,0.3333333333333333
580,Winston-Salem Dash,2019,13,High-A,9,2,2,1,3,2,0,2,0.6666666666666666,1.0
582,West Michigan Whitecaps,2019,14,A,4,26,28,13,41,23,4,27,0.6829268292682927,0.8518518518518519
584,Fort Wayne TinCaps,2019,14,A,4,28,37,6,43,42,14,56,0.8604651162790697,0.75
587,Tampa Tarpons,2019,13,High-A,4,25,20,17,37,30,16,46,0.5405405405405406,0.6521739130434783
587,Tampa Tarpons,2019,13,High-A,5,38,33,21,54,17,20,37,0.6111111111111112,0.4594594594594595
587,Tampa Tarpons,2019,13,High-A,6,32,22,17,39,33,17,50,0.5641025641025641,0.66
587,Tampa Tarpons,2019,13,High-A,7,41,36,9,45,32,18,50,0.8,0.64
587,Tampa Tarpons,2019,13,High-A,8,36,18,7,25,28,14,42,0.72,0.6666666666666666
587,Tampa Tarpons,2019,13,High-A,9,1,0,0,0,0,0,0,,
588,New Orleans Baby Cakes,2019,11,AAA,4,33,29,8,37,14,12,26,0.7837837837837838,0.5384615384615384
588,New Orleans Baby Cakes,2019,11,AAA,5,35,43,12,55,25,9,34,0.7818181818181819,0.7352941176470589
588,New Orleans Baby Cakes,2019,11,AAA,6,27,35,12,47,9,8,17,0.7446808510638298,0.5294117647058824
588,New Orleans Baby Cakes,2019,11,AAA,7,30,26,9,35,20,8,28,0.7428571428571429,0.7142857142857143
588,New Orleans Baby Cakes,2019,11,AAA,8,34,25,9,34,12,10,22,0.7352941176470589,0.5454545454545454
588,New Orleans Baby Cakes,2019,11,AAA,9,2,0,1,1,0,0,0,0.0,
1350,Northwest Arkansas Naturals,2019,12,AA,4,25,39,10,49,23,6,29,0.7959183673469388,0.7931034482758621
1350,Northwest Arkansas Naturals,2019,12,AA,5,35,75,14,89,21,6,27,0.8426966292134831,0.7777777777777778
1350,Northwest Arkansas Naturals,2019,12,AA,6,30,55,13,68,19,15,34,0.8088235294117647,0.5588235294117647
1350,Northwest Arkansas Naturals,2019,12,AA,7,28,39,16,55,14,7,21,0.7090909090909091,0.6666666666666666
1350,Northwest Arkansas Naturals,2019,12,AA,8,35,40,18,58,23,17,40,0.6896551724137931,0.575
1350,Northwest Arkansas Naturals,2019,12,AA,9,2,3,0,3,1,0,1,1.0,1.0
1410,Lehigh Valley IronPigs,2019,11,AAA,4,35,24,18,42,22,3,25,0.5714285714285714,0.88
1410,Lehigh Valley IronPigs,2019,11,AAA,5,36,26,8,34,37,11,48,0.7647058823529411,0.7708333333333334
1410,Lehigh Valley IronPigs,2019,11,AAA,6,28,13,7,20,29,9,38,0.65,0.7631578947368421
1410,Lehigh Valley IronPigs,2019,11,AAA,7,35,8,7,15,25,6,31,0.5333333333333333,0.8064516129032258
1410,Lehigh Valley IronPigs,2019,11,AAA,8,36,14,3,17,26,6,32,0.8235294117647058,0.8125
1410,Lehigh Valley IronPigs,2019,11,AAA,9,2,0,3,3,0,1,1,0.0,0.0
2310,Reno Aces,2019,11,AAA,4,30,11,7,18,15,12,27,0.6111111111111112,0.5555555555555556
2310,Reno Aces,2019,11,AAA,5,30,12,6,18,28,9,37,0.6666666666666666,0.7567567567567568
2310,Reno Aces,2019,11,AAA,6,27,10,3,13,19,9,28,0.7692307692307693,0.6785714285714286
2310,Reno Aces,2019,11,AAA,7,28,11,9,20,14,7,21,0.55,0.6666666666666666
2310,Reno Aces,2019,11,AAA,8,29,5,9,14,16,6,22,0.35714285714285715,0.7272727272727273
2310,Reno Aces,2019,11,AAA,9,2,0,1,1,1,1,2,0.0,0.5
2498,Bowling Green Hot Rods,2019,14,A,4,27,37,9,46,44,6,50,0.8043478260869565,0.88
2730,Charlotte Stone Crabs,2019,13,High-A,4,25,29,12,41,23,11,34,0.7073170731707317,0.6764705882352942
2730,Charlotte Stone Crabs,2019,13,High-A,5,29,33,14,47,4,2,6,0.7021276595744681,0.6666666666666666
2730,Charlotte Stone Crabs,2019,13,High-A,6,33,60,12,72,20,4,24,0.8333333333333334,0.8333333333333334
2730,Charlotte Stone Crabs,2019,13,High-A,7,39,52,22,74,36,26,62,0.7027027027027027,0.5806451612903226
2730,Charlotte Stone Crabs,2019,13,High-A,8,27,12,11,23,15,5,20,0.5217391304347826,0.75
3390,Bradenton Marauders,2019,13,High-A,4,25,25,8,33,28,10,38,0.7575757575757576,0.7368421052631579
3390,Bradenton Marauders,2019,13,High-A,5,38,29,16,45,35,9,44,0.6444444444444445,0.7954545454545454
3390,Bradenton Marauders,2019,13,High-A,6,32,33,17,50,45,6,51,0.66,0.8823529411764706
3390,Bradenton Marauders,2019,13,High-A,7,40,18,13,31,22,7,29,0.5806451612903226,0.7586206896551724
3390,Bradenton Marauders,2019,13,High-A,8,35,24,10,34,15,5,20,0.7058823529411765,0.75
3390,Bradenton Marauders,2019,13,High-A,9,1,0,0,0,0,0,0,,
3410,Richmond Flying Squirrels,2019,12,AA,4,32,16,14,30,21,9,30,0.5333333333333333,0.7
3410,Richmond Flying Squirrels,2019,12,AA,5,30,30,15,45,18,11,29,0.6666666666666666,0.6206896551724138
3410,Richmond Flying Squirrels,2019,12,AA,6,30,37,21,58,24,17,41,0.6379310344827587,0.5853658536585366
3410,Richmond Flying Squirrels,2019,12,AA,7,33,20,17,37,44,8,52,0.5405405405405406,0.8461538461538461
3410,Richmond Flying Squirrels,2019,12,AA,8,46,34,36,70,18,8,26,0.4857142857142857,0.6923076923076923
3410,Richmond Flying Squirrels,2019,12,AA,9,2,2,0,2,0,0,0,1.0,
3705,Columbia Fireflies,2019,14,A,4,25,7,9,16,14,8,22,0.4375,0.6363636363636364
3712,Fayetteville Woodpeckers,2019,13,High-A,4,32,17,15,32,24,5,29,0.53125,0.8275862068965517
3712,Fayetteville Woodpeckers,2019,13,High-A,5,32,10,9,19,23,11,34,0.5263157894736842,0.6764705882352942
3712,Fayetteville Woodpeckers,2019,13,High-A,6,26,21,12,33,29,10,39,0.6363636363636364,0.7435897435897436
3712,Fayetteville Woodpeckers,2019,13,High-A,7,36,23,14,37,22,11,33,0.6216216216216216,0.6666666666666666
3712,Fayetteville Woodpeckers,2019,13,High-A,8,29,5,14,19,11,12,23,0.2631578947368421,0.4782608695652174
3712,Fayetteville Woodpeckers,2019,13,High-A,9,2,3,2,5,2,1,3,0.6,0.6666666666666666
4124,Pensacola Blue Wahoos,2019,12,AA,4,31,21,9,30,30,7,37,0.7,0.8108108108108109
4124,Pensacola Blue Wahoos,2019,12,AA,5,32,13,11,24,20,7,27,0.5416666666666666,0.7407407407407407
4124,Pensacola Blue Wahoos,2019,12,AA,6,30,20,11,31,32,7,39,0.6451612903225806,0.8205128205128205
4124,Pensacola Blue Wahoos,2019,12,AA,7,33,19,11,30,31,20,51,0.6333333333333333,0.6078431372549019
4124,Pensacola Blue Wahoos,2019,12,AA,8,30,21,7,28,23,10,33,0.75,0.696969696969697
4124,Pensacola Blue Wahoos,2019,12,AA,9,2,0,0,0,3,1,4,,0.75
4444,Generales de Durango,2019,11,AAA,4,22,6,3,9,13,4,17,0.6666666666666666,0.7647058823529411
4444,Generales de Durango,2019,11,AAA,5,27,3,7,10,21,12,33,0.3,0.6363636363636364
4444,Generales de Durango,2019,11,AAA,6,20,7,11,18,18,9,27,0.3888888888888889,0.6666666666666666
4444,Generales de Durango,2019,11,AAA,7,29,8,8,16,31,8,39,0.5,0.7948717948717948
4444,Generales de Durango,2019,11,AAA,8,33,19,7,26,16,3,19,0.7307692307692307,0.8421052631578947
4904,El Paso Chihuahuas,2019,11,AAA,4,27,5,4,9,12,6,18,0.5555555555555556,0.6666666666666666
4904,El Paso Chihuahuas,2019,11,AAA,5,36,24,7,31,18,4,22,0.7741935483870968,0.8181818181818182
4904,El Paso Chihuahuas,2019,11,AAA,6,27,13,4,17,10,7,17,0.7647058823529411,0.5882352941176471
4904,El Paso Chihuahuas,2019,11,AAA,7,28,9,3,12,16,6,22,0.75,0.7272727272727273
4904,El Paso Chihuahuas,2019,11,AAA,8,29,16,8,24,24,7,31,0.6666666666666666,0.7741935483870968
4904,El Paso Chihuahuas,2019,11,AAA,9,2,1,2,3,1,0,1,0.3333333333333333,1.0
5010,Toros de Tijuana,2019,11,AAA,4,25,18,4,22,10,7,17,0.8181818181818182,0.5882352941176471
5010,Toros de Tijuana,2019,11,AAA,5,27,28,11,39,11,8,19,0.717948717948718,0.5789473684210527
5010,Toros de Tijuana,2019,11,AAA,6,23,18,11,29,8,8,16,0.6206896551724138,0.5
5010,Toros de Tijuana,2019,11,AAA,7,26,27,11,38,16,6,22,0.7105263157894737,0.7272727272727273
5010,Toros de Tijuana,2019,11,AAA,8,25,20,15,35,8,4,12,0.5714285714285714,0.6666666666666666
5015,Biloxi Shuckers,2019,12,AA,4,34,41,10,51,29,12,41,0.803921568627451,0.7073170731707317
5015,Biloxi Shuckers,2019,12,AA,5,29,31,14,45,13,13,26,0.6888888888888889,0.5
5015,Biloxi Shuckers,2019,12,AA,6,27,25,9,34,20,5,25,0.7352941176470589,0.8
5015,Biloxi Shuckers,2019,12,AA,7,38,28,14,42,8,9,17,0.6666666666666666,0.47058823529411764
5015,Biloxi Shuckers,2019,12,AA,8,34,9,15,24,25,17,42,0.375,0.5952380952380952
5015,Biloxi Shuckers,2019,12,AA,9,2,1,0,1,0,0,0,1.0,
5368,Amarillo Sod Poodles,2019,12,AA,4,25,14,7,21,20,10,30,0.6666666666666666,0.6666666666666666
5368,Amarillo Sod Poodles,2019,12,AA,5,35,37,10,47,19,17,36,0.7872340425531915,0.5277777777777778
5368,Amarillo Sod Poodles,2019,12,AA,6,26,21,16,37,17,12,29,0.5675675675675675,0.5862068965517241
5368,Amarillo Sod Poodles,2019,12,AA,7,28,17,7,24,27,16,43,0.7083333333333334,0.627906976744186
5368,Amarillo Sod Poodles,2019,12,AA,8,33,38,13,51,16,8,24,0.7450980392156863,0.6666666666666666
5368,Amarillo Sod Poodles,2019,12,AA,9,2,1,1,2,1,0,1,0.5,1.0
