team_id,team_name,season,level_id,level_name,month,games,sb,cs,attempts,sb_allowed,cs_allowed,attempts_allowed,success_rate,success_rate_allowed
102,Round Rock Express,2022,11,AAA,6,23,21,4,25,21,4,25,0.84,0.84
102,Round Rock Express,2022,11,AAA,7,24,28,8,36,15,5,20,0.7777777777777778,0.75
102,Round Rock Express,2022,11,AAA,8,26,21,6,27,24,5,29,0.7777777777777778,0.8275862068965517
102,Round Rock Express,2022,11,AAA,9,25,10,2,12,24,11,35,0.8333333333333334,0.6857142857142857
103,Lake Elsinore Storm,2022,14,A,4,23,48,12,60,34,10,44,0.8,0.7727272727272727
103,Lake Elsinore Storm,2022,14,A,5,29,57,12,69,36,6,42,0.8260869565217391,0.8571428571428571
103,Lake Elsinore Storm,2022,14,A,6,26,57,13,70,36,7,43,0.8142857142857143,0.8372093023255814
103,Lake Elsinore Storm,2022,14,A,7,24,36,11,47,36,7,43,0.7659574468085106,0.8372093023255814
103,Lake Elsinore Storm,2022,14,A,8,26,37,13,50,29,13,42,0.74,0.6904761904761905
103,Lake Elsinore Storm,2022,14,A,9,13,39,10,49,21,2,23,0.7959183673469388,0.9130434782608695
105,Sacramento River Cats,2022,11,AAA,6,23,11,7,18,24,10,34,0.6111111111111112,0.7058823529411765
105,Sacramento River Cats,2022,11,AAA,7,24,22,5,27,28,8,36,0.8148148148148148,0.7777777777777778
105,Sacramento River Cats,2022,11,AAA,8,26,13,4,17,15,5,20,0.7647058823529411,0.75
105,Sacramento River Cats,2022,11,AAA,9,28,9,1,10,28,5,33,0.9,0.8484848484848485
106,Erie SeaWolves,2022,12,AA,4,26,37,5,42,11,7,18,0.8809523809523809,0.6111111111111112
106,Erie SeaWolves,2022,12,AA,5,32,31,10,41,15,13,28,0.7560975609756098,0.5357142857142857
106,Erie SeaWolves,2022,12,AA,6,26,17,7,24,19,6,25,0.7083333333333334,0.76
106,Erie SeaWolves,2022,12,AA,7,25,27,4,31,13,9,22,0.8709677419354839,0.5909090909090909
106,Erie SeaWolves,2022,12,AA,8,19,17,2,19,12,4,16,0.8947368421052632,0.75
106,Erie SeaWolves,2022,12,AA,9,16,12,2,14,6,4,10,0.8571428571428571,0.6
233,Charleston RiverDogs,2022,14,A,4,20,43,7,50,21,4,25,0.86,0.84
233,Charleston RiverDogs,2022,14,A,5,26,56,10,66,21,6,27,0.8484848484848485,0.7777777777777778
233,Charleston RiverDogs,2022,14,A,6,26,38,11,49,39,10,49,0.7755102040816326,0.7959183673469388
233,Charleston RiverDogs,2022,14,A,7,28,41,7,48,49,6,55,0.8541666666666666,0.8909090909090909
233,Charleston RiverDogs,2022,14,A,8,34,59,10,69,47,9,56,0.855072463768116,0.8392857142857143
233,Charleston RiverDogs,2022,14,A,9,10,20,4,24,13,8,21,0.8333333333333334,0.6190476190476191
234,Durham Bulls,2022,11,AAA,6,23,21,5,26,18,7,25,0.8076923076923077,0.72
234,Durham Bulls,2022,11,AAA,7,24,17,8,25,20,5,25,0.68,0.8
234,Durham Bulls,2022,11,AAA,8,27,30,3,33,32,4,36,0.9090909090909091,0.8888888888888888
234,Durham Bulls,2022,11,AAA,9,27,40,9,49,26,7,33,0.8163265306122449,0.7878787878787878
235,Memphis Redbirds,2022,11,AAA,6,23,21,8,29,17,5,22,0.7241379310344828,0.7727272727272727
235,Memphis Redbirds,2022,11,AAA,7,26,25,7,32,25,7,32,0.78125,0.78125
235,Memphis Redbirds,2022,11,AAA,8,32,33,11,44,29,6,35,0.75,0.8285714285714286
235,Memphis Redbirds,2022,11,AAA,9,34,27,19,46,40,12,52,0.5869565217391305,0.7692307692307693
237,Midland RockHounds,2022,12,AA,4,20,15,3,18,25,5,30,0.8333333333333334,0.8333333333333334
237,Midland RockHounds,2022,12,AA,5,26,13,7,20,28,6,34,0.65,0.8235294117647058
237,Midland RockHounds,2022,12,AA,6,26,12,5,17,28,10,38,0.7058823529411765,0.7368421052631579
237,Midland RockHounds,2022,12,AA,7,24,15,8,23,19,5,24,0.6521739130434783,0.7916666666666666
237,Midland RockHounds,2022,12,AA,8,18,14,3,17,12,6,18,0.8235294117647058,0.6666666666666666
237,Midland RockHounds,2022,12,AA,9,25,9,3,12,21,2,23,0.75,0.9130434782608695
238,Oklahoma City Dodgers,2022,11,AAA,6,23,16,8,24,26,5,31,0.6666666666666666,0.8387096774193549
238,Oklahoma City Dodgers,2022,11,AAA,7,27,26,6,32,34,7,41,0.8125,0.8292682926829268
238,Oklahoma City Dodgers,2022,11,AAA,8,29,20,3,23,30,3,33,0.8695652173913043,0.9090909090909091
238,Oklahoma City Dodgers,2022,11,AAA,9,28,23,12,35,27,1,28,0.6571428571428571,0.9642857142857143
247,Birmingham Barons,2022,12,AA,4,20,10,7,17,28,3,31,0.5882352941176471,0.9032258064516129
247,Birmingham Barons,2022,12,AA,5,26,30,11,41,23,13,36,0.7317073170731707,0.6388888888888888
247,Birmingham Barons,2022,12,AA,6,29,57,19,76,35,10,45,0.75,0.7777777777777778
247,Birmingham Barons,2022,12,AA,7,27,47,8,55,40,7,47,0.8545454545454545,0.851063829787234
247,Birmingham Barons,2022,12,AA,8,18,22,10,32,31,9,40,0.6875,0.775
247,Birmingham Barons,2022,12,AA,9,16,29,5,34,25,6,31,0.8529411764705882,0.8064516129032258
249,Carolina Mudcats,2022,14,A,4,23,16,8,24,30,9,39,0.6666666666666666,0.7692307692307693
249,Carolina Mudcats,2022,14,A,5,29,32,8,40,53,13,66,0.8,0.803030303030303
249,Carolina Mudcats,2022,14,A,6,35,25,13,38,31,39,70,0.6578947368421053,0.44285714285714284
249,Carolina Mudcats,2022,14,A,7,24,37,11,48,30,19,49,0.7708333333333334,0.6122448979591837
249,Carolina Mudcats,2022,14,A,8,29,28,17,45,32,13,45,0.6222222222222222,0.7111111111111111
249,Carolina Mudcats,2022,14,A,9,10,19,4,23,12,6,18,0.8260869565217391,0.6666666666666666
259,Fresno Grizzlies,2022,14,A,4,23,38,7,45,9,9,18,0.8444444444444444,0.5
259,Fresno Grizzlies,2022,14,A,5,26,40,12,52,18,9,27,0.7692307692307693,0.6666666666666666
259,Fresno Grizzlies,2022,14,A,6,26,36,8,44,19,12,31,0.8181818181818182,0.6129032258064516
259,Fresno Grizzlies,2022,14,A,7,24,38,10,48,19,5,24,0.7916666666666666,0.7916666666666666
259,Fresno Grizzlies,2022,14,A,8,26,28,14,42,23,13,36,0.6666666666666666,0.6388888888888888
259,Fresno Grizzlies,2022,14,A,9,10,9,2,11,4,3,7,0.8181818181818182,0.5714285714285714
260,Tulsa Drillers,2022,12,AA,4,20,10,3,13,26,4,30,0.7692307692307693,0.8666666666666667
260,Tulsa Drillers,2022,12,AA,5,45,32,6,38,90,8,98,0.8421052631578947,0.9183673469387755
260,Tulsa Drillers,2022,12,AA,6,32,21,4,25,44,8,52,0.84,0.8461538461538461
260,Tulsa Drillers,2022,12,AA,7,24,19,5,24,58,4,62,0.7916666666666666,0.9354838709677419
260,Tulsa Drillers,2022,12,AA,8,18,23,3,26,30,4,34,0.8846153846153846,0.8823529411764706
260,Tulsa Drillers,2022,12,AA,9,19,20,6,26,41,8,49,0.7692307692307693,0.8367346938775511
279,Palm Beach Cardinals,2022,14,A,4,20,10,6,16,16,5,21,0.625,0.7619047619047619
279,Palm Beach Cardinals,2022,14,A,5,35,10,5,15,79,10,89,0.6666666666666666,0.8876404494382022
279,Palm Beach Cardinals,2022,14,A,6,50,18,24,42,45,8,53,0.42857142857142855,0.8490566037735849
279,Palm Beach Cardinals,2022,14,A,7,27,19,7,26,30,8,38,0.7307692307692307,0.7894736842105263
279,Palm Beach Cardinals,2022,14,A,8,32,29,10,39,31,11,42,0.7435897435897436,0.7380952380952381
279,Palm Beach Cardinals,2022,14,A,9,10,6,1,7,10,4,14,0.8571428571428571,0.7142857142857143
342,Albuquerque Isotopes,2022,11,AAA,6,26,15,1,16,24,3,27,0.9375,0.8888888888888888
342,Albuquerque Isotopes,2022,11,AAA,7,24,21,5,26,27,11,38,0.8076923076923077,0.7105263157894737
342,Albuquerque Isotopes,2022,11,AAA,8,30,17,13,30,30,8,38,0.5666666666666667,0.7894736842105263
342,Albuquerque Isotopes,2022,11,AAA,9,30,13,8,21,29,10,39,0.6190476190476191,0.7435897435897436
400,Las Vegas Aviators,2022,11,AAA,6,26,9,4,13,41,7,48,0.6923076923076923,0.8541666666666666
400,Las Vegas Aviators,2022,11,AAA,7,24,14,6,20,21,7,28,0.7,0.75
400,Las Vegas Aviators,2022,11,AAA,8,28,11,3,14,19,8,27,0.7857142857142857,0.7037037037037037
400,Las Vegas Aviators,2022,11,AAA,9,25,11,2,13,20,4,24,0.8461538461538461,0.8333333333333334
401,Inland Empire 66ers,2022,14,A,4,20,28,10,38,40,7,47,0.7368421052631579,0.851063829787234
401,Inland Empire 66ers,2022,14,A,5,29,38,9,47,33,7,40,0.8085106382978723,0.825
401,Inland Empire 66ers,2022,14,A,6,29,38,9,47,43,18,61,0.8085106382978723,0.7049180327868853
401,Inland Empire 66ers,2022,14,A,7,24,47,11,58,17,15,32,0.8103448275862069,0.53125
401,Inland Empire 66ers,2022,14,A,8,26,57,12,69,19,10,29,0.8260869565217391,0.6551724137931034
401,Inland Empire 66ers,2022,14,A,9,10,21,7,28,7,0,7,0.75,1.0
402,Akron RubberDucks,2022,12,AA,4,20,15,6,21,14,3,17,0.7142857142857143,0.8235294117647058
402,Akron RubberDucks,2022,12,AA,5,29,26,8,34,22,11,33,0.7647058823529411,0.6666666666666666
402,Akron RubberDucks,2022,12,AA,6,29,24,11,35,21,5,26,0.6857142857142857,0.8076923076923077
402,Akron RubberDucks,2022,12,AA,7,32,27,10,37,31,11,42,0.7297297297297297,0.7380952380952381
402,Akron RubberDucks,2022,12,AA,8,25,36,7,43,19,2,21,0.8372093023255814,0.9047619047619048
402,Akron RubberDucks,2022,12,AA,9,16,12,5,17,6,5,11,0.7058823529411765,0.5454545454545454
403,Everett AquaSox,2022,13,High-A,4,21,22,2,24,42,10,52,0.9166666666666666,0.8076923076923077
403,Everett AquaSox,2022,13,High-A,5,31,27,4,31,50,7,57,0.8709677419354839,0.8771929824561403
403,Everett AquaSox,2022,13,High-A,6,29,24,13,37,34,18,52,0.6486486486486487,0.6538461538461539
403,Everett AquaSox,2022,13,High-A,7,24,21,5,26,40,10,50,0.8076923076923077,0.8
403,Everett AquaSox,2022,13,High-A,8,26,12,9,21,36,6,42,0.5714285714285714,0.8571428571428571
403,Everett AquaSox,2022,13,High-A,9,10,11,1,12,23,3,26,0.9166666666666666,0.8846153846153846
404,ACL Angels,2022,16,Rookie,6,18,16,2,18,16,2,18,0.8888888888888888,0.8888888888888888
404,ACL Angels,2022,16,Rookie,7,20,16,10,26,16,6,22,0.6153846153846154,0.7272727272727273
404,ACL Angels,2022,16,Rookie,8,20,8,5,13,5,1,6,0.6153846153846154,0.8333333333333334
406,ACL Brewers Gold,2022,16,Rookie,6,18,17,6,23,19,14,33,0.7391304347826086,0.5757575757575758
406,ACL Brewers Gold,2022,16,Rookie,7,21,19,3,22,21,9,30,0.8636363636363636,0.7
406,ACL Brewers Gold,2022,16,Rookie,8,22,57,5,62,28,10,38,0.9193548387096774,0.7368421052631579
407,ACL Cubs,2022,16,Rookie,6,18,17,13,30,32,7,39,0.5666666666666667,0.8205128205128205
407,ACL Cubs,2022,16,Rookie,7,21,31,11,42,35,8,43,0.7380952380952381,0.813953488372093
407,ACL Cubs,2022,16,Rookie,8,22,33,8,41,44,11,55,0.8048780487804879,0.8
408,ACL Giants Black,2022,16,Rookie,6,19,7,4,11,11,7,18,0.6363636363636364,0.6111111111111112
408,ACL Giants Black,2022,16,Rookie,7,22,14,5,19,9,14,23,0.7368421052631579,0.391304347826087
408,ACL Giants Black,2022,16,Rookie,8,20,10,5,15,11,3,14,0.6666666666666666,0.7857142857142857
409,ACL Mariners,2022,16,Rookie,6,18,11,6,17,15,7,22,0.6470588235294118,0.6818181818181818
409,ACL Mariners,2022,16,Rookie,7,20,37,17,54,18,15,33,0.6851851851851852,0.5454545454545454
409,ACL Mariners,2022,16,Rookie,8,17,36,6,42,13,6,19,0.8571428571428571,0.6842105263157895
410,ACL Padres,2022,16,Rookie,6,18,19,10,29,13,6,19,0.6551724137931034,0.6842105263157895
410,ACL Padres,2022,16,Rookie,7,20,27,11,38,32,8,40,0.7105263157894737,0.8
410,ACL Padres,2022,16,Rookie,8,17,10,6,16,31,6,37,0.625,0.8378378378378378
411,ACL Rangers,2022,16,Rookie,6,18,29,9,38,22,3,25,0.7631578947368421,0.88
411,ACL Rangers,2022,16,Rookie,7,20,45,15,60,38,5,43,0.75,0.8837209302325582
411,ACL Rangers,2022,16,Rookie,8,17,22,9,31,9,6,15,0.7096774193548387,0.6
412,ACL Royals,2022,16,Rookie,6,19,28,9,37,21,6,27,0.7567567567567568,0.7777777777777778
412,ACL Royals,2022,16,Rookie,7,23,37,10,47,23,13,36,0.7872340425531915,0.6388888888888888
412,ACL Royals,2022,16,Rookie,8,19,19,5,24,15,2,17,0.7916666666666666,0.8823529411764706
414,Salem Red Sox,2022,14,A,4,26,26,2,28,44,4,48,0.9285714285714286,0.9166666666666666
414,Salem Red Sox,2022,14,A,5,32,34,8,42,39,6,45,0.8095238095238095,0.8666666666666667
414,Salem Red Sox,2022,14,A,6,26,43,5,48,25,10,35,0.8958333333333334,0.7142857142857143
414,Salem Red Sox,2022,14,A,7,34,42,16,58,38,13,51,0.7241379310344828,0.7450980392156863
414,Salem Red Sox,2022,14,A,8,29,61,10,71,33,11,44,0.8591549295774648,0.75
414,Salem Red Sox,2022,14,A,9,12,12,3,15,15,2,17,0.8,0.8823529411764706
416,Louisville Bats,2022,11,AAA,6,22,13,3,16,27,10,37,0.8125,0.7297297297297297
416,Louisville Bats,2022,11,AAA,7,24,15,3,18,29,4,33,0.8333333333333334,0.8787878787878788
416,Louisville Bats,2022,11,AAA,8,28,15,7,22,39,5,44,0.6818181818181818,0.8863636363636364
416,Louisville Bats,2022,11,AAA,9,25,21,2,23,27,5,32,0.9130434782608695,0.84375
418,Bowie Baysox,2022,12,AA,4,21,21,3,24,15,9,24,0.875,0.625
418,Bowie Baysox,2022,12,AA,5,38,20,3,23,15,5,20,0.8695652173913043,0.75
418,Bowie Baysox,2022,12,AA,6,30,22,3,25,11,10,21,0.88,0.5238095238095238
418,Bowie Baysox,2022,12,AA,7,28,7,5,12,21,8,29,0.5833333333333334,0.7241379310344828
418,Bowie Baysox,2022,12,AA,8,19,6,4,10,20,5,25,0.6,0.8
418,Bowie Baysox,2022,12,AA,9,16,5,5,10,12,1,13,0.5,0.9230769230769231
419,Hillsboro Hops,2022,13,High-A,4,20,34,9,43,25,4,29,0.7906976744186046,0.8620689655172413
419,Hillsboro Hops,2022,13,High-A,5,29,20,16,36,24,8,32,0.5555555555555556,0.75
419,Hillsboro Hops,2022,13,High-A,6,26,26,11,37,28,7,35,0.7027027027027027,0.8
419,Hillsboro Hops,2022,13,High-A,7,24,36,11,47,29,6,35,0.7659574468085106,0.8285714285714286
419,Hillsboro Hops,2022,13,High-A,8,26,58,11,69,22,3,25,0.8405797101449275,0.88
419,Hillsboro Hops,2022,13,High-A,9,10,19,4,23,19,3,22,0.8260869565217391,0.8636363636363636
421,Montgomery Biscuits,2022,12,AA,4,21,29,10,39,17,9,26,0.7435897435897436,0.6538461538461539
421,Montgomery Biscuits,2022,12,AA,5,28,29,14,43,23,13,36,0.6744186046511628,0.6388888888888888
421,Montgomery Biscuits,2022,12,AA,6,31,71,7,78,24,9,33,0.9102564102564102,0.7272727272727273
421,Montgomery Biscuits,2022,12,AA,7,30,61,12,73,38,2,40,0.8356164383561644,0.95
421,Montgomery Biscuits,2022,12,AA,8,24,38,14,52,28,12,40,0.7307692307692307,0.7
421,Montgomery Biscuits,2022,12,AA,9,16,26,5,31,12,5,17,0.8387096774193549,0.7058823529411765
422,Buffalo Bisons,2022,11,AAA,6,25,24,7,31,38,12,50,0.7741935483870968,0.76
422,Buffalo Bisons,2022,11,AAA,7,26,20,5,25,14,7,21,0.8,0.6666666666666666
422,Buffalo Bisons,2022,11,AAA,8,27,32,10,42,27,6,33,0.7619047619047619,0.8181818181818182
422,Buffalo Bisons,2022,11,AAA,9,30,29,9,38,24,5,29,0.7631578947368421,0.8275862068965517
424,Dunedin Blue Jays,2022,14,A,4,20,21,11,32,32,11,43,0.65625,0.7441860465116279
424,Dunedin Blue Jays,2022,14,A,5,29,32,12,44,40,14,54,0.7272727272727273,0.7407407407407407
424,Dunedin Blue Jays,2022,14,A,6,29,21,9,30,36,23,59,0.7,0.6101694915254238
424,Dunedin Blue Jays,2022,14,A,7,39,49,15,64,13,16,29,0.765625,0.4482758620689655
424,Dunedin Blue Jays,2022,14,A,8,37,16,18,34,58,15,73,0.47058823529411764,0.7945205479452054
424,Dunedin Blue Jays,2022,14,A,9,16,5,7,12,8,4,12,0.4166666666666667,0.6666666666666666
426,Wilmington Blue Rocks,2022,13,High-A,4,26,26,2,28,35,10,45,0.9285714285714286,0.7777777777777778
426,Wilmington Blue Rocks,2022,13,High-A,5,49,66,17,83,54,13,67,0.7951807228915663,0.8059701492537313
426,Wilmington Blue Rocks,2022,13,High-A,6,32,56,11,67,22,6,28,0.835820895522388,0.7857142857142857
426,Wilmington Blue Rocks,2022,13,High-A,7,32,31,5,36,23,22,45,0.8611111111111112,0.5111111111111111
426,Wilmington Blue Rocks,2022,13,High-A,8,29,36,10,46,28,12,40,0.782608695652174,0.7
426,Wilmington Blue Rocks,2022,13,High-A,9,10,13,2,15,2,3,5,0.8666666666666667,0.4
427,Jersey Shore BlueClaws,2022,13,High-A,4,23,54,3,57,30,3,33,0.9473684210526315,0.9090909090909091
427,Jersey Shore BlueClaws,2022,13,High-A,5,34,42,22,64,35,10,45,0.65625,0.7777777777777778
427,Jersey Shore BlueClaws,2022,13,High-A,6,33,32,14,46,35,6,41,0.6956521739130435,0.8536585365853658
427,Jersey Shore BlueClaws,2022,13,High-A,7,38,32,15,47,34,8,42,0.6808510638297872,0.8095238095238095
427,Jersey Shore BlueClaws,2022,13,High-A,8,32,21,8,29,30,5,35,0.7241379310344828,0.8571428571428571
427,Jersey Shore BlueClaws,2022,13,High-A,9,13,12,3,15,18,3,21,0.8,0.8571428571428571
428,Greenville Drive,2022,13,High-A,4,20,23,5,28,24,4,28,0.8214285714285714,0.8571428571428571
428,Greenville Drive,2022,13,High-A,5,29,32,9,41,28,15,43,0.7804878048780488,0.6511627906976745
428,Greenville Drive,2022,13,High-A,6,29,17,5,22,27,12,39,0.7727272727272727,0.6923076923076923
428,Greenville Drive,2022,13,High-A,7,28,18,10,28,21,7,28,0.6428571428571429,0.75
428,Greenville Drive,2022,13,High-A,8,28,29,8,37,44,2,46,0.7837837837837838,0.9565217391304348
428,Greenville Drive,2022,13,High-A,9,10,17,1,18,7,1,8,0.9444444444444444,0.875
430,Mississippi Braves,2022,12,AA,4,20,19,5,24,23,8,31,0.7916666666666666,0.7419354838709677
430,Mississippi Braves,2022,12,AA,5,26,17,4,21,37,7,44,0.8095238095238095,0.8409090909090909
430,Mississippi Braves,2022,12,AA,6,29,28,9,37,38,16,54,0.7567567567567568,0.7037037037037037
430,Mississippi Braves,2022,12,AA,7,27,23,5,28,36,11,47,0.8214285714285714,0.7659574468085106
430,Mississippi Braves,2022,12,AA,8,24,27,2,29,28,2,30,0.9310344827586207,0.9333333333333333
430,Mississippi Braves,2022,12,AA,9,19,14,2,16,39,5,44,0.875,0.8863636363636364
431,Gwinnett Stripers,2022,11,AAA,6,22,15,5,20,18,6,24,0.75,0.75
431,Gwinnett Stripers,2022,11,AAA,7,27,20,5,25,25,5,30,0.8,0.8333333333333334
431,Gwinnett Stripers,2022,11,AAA,8,32,31,2,33,48,10,58,0.9393939393939394,0.8275862068965517
431,Gwinnett Stripers,2022,11,AAA,9,31,26,3,29,43,5,48,0.896551724137931,0.8958333333333334
432,Rome Braves,2022,13,High-A,4,20,14,7,21,37,7,44,0.6666666666666666,0.8409090909090909
432,Rome Braves,2022,13,High-A,5,26,24,8,32,57,8,65,0.75,0.8769230769230769
432,Rome Braves,2022,13,High-A,6,26,22,6,28,42,8,50,0.7857142857142857,0.84
432,Rome Braves,2022,13,High-A,7,27,34,10,44,35,8,43,0.7727272727272727,0.813953488372093
432,Rome Braves,2022,13,High-A,8,26,33,7,40,35,9,44,0.825,0.7954545454545454
432,Rome Braves,2022,13,High-A,9,13,16,1,17,18,5,23,0.9411764705882353,0.782608695652174
435,Vancouver Canadians,2022,13,High-A,4,29,21,7,28,32,12,44,0.75,0.7272727272727273
435,Vancouver Canadians,2022,13,High-A,5,32,55,11,66,44,1,45,0.8333333333333334,0.9777777777777777
435,Vancouver Canadians,2022,13,High-A,6,42,34,13,47,56,16,72,0.723404255319149,0.7777777777777778
435,Vancouver Canadians,2022,13,High-A,7,25,56,14,70,32,9,41,0.8,0.7804878048780488
435,Vancouver Canadians,2022,13,High-A,8,31,30,9,39,37,12,49,0.7692307692307693,0.7551020408163265
435,Vancouver Canadians,2022,13,High-A,9,10,5,3,8,20,2,22,0.625,0.9090909090909091
436,Fredericksburg Nationals,2022,14,A,4,20,31,6,37,18,7,25,0.8378378378378378,0.72
436,Fredericksburg Nationals,2022,14,A,5,42,60,23,83,29,5,34,0.7228915662650602,0.8529411764705882
436,Fredericksburg Nationals,2022,14,A,6,35,40,12,52,17,3,20,0.7692307692307693,0.85
436,Fredericksburg Nationals,2022,14,A,7,31,44,10,54,25,10,35,0.8148148148148148,0.7142857142857143
436,Fredericksburg Nationals,2022,14,A,8,29,62,4,66,33,12,45,0.9393939393939394,0.7333333333333333
436,Fredericksburg Nationals,2022,14,A,9,12,22,2,24,11,1,12,0.9166666666666666,0.9166666666666666
437,Lake County Captains,2022,13,High-A,4,32,29,2,31,21,14,35,0.9354838709677419,0.6
437,Lake County Captains,2022,13,High-A,5,33,21,11,32,26,7,33,0.65625,0.7878787878787878
437,Lake County Captains,2022,13,High-A,6,28,17,8,25,27,7,34,0.68,0.7941176470588235
437,Lake County Captains,2022,13,High-A,7,30,13,11,24,18,8,26,0.5416666666666666,0.6923076923076923
437,Lake County Captains,2022,13,High-A,8,29,41,9,50,22,4,26,0.82,0.8461538461538461
437,Lake County Captains,2022,13,High-A,9,13,11,2,13,3,2,5,0.8461538461538461,0.6
440,Springfield Cardinals,2022,12,AA,4,20,23,3,26,16,4,20,0.8846153846153846,0.8
440,Springfield Cardinals,2022,12,AA,5,29,19,6,25,20,17,37,0.76,0.5405405405405406
440,Springfield Cardinals,2022,12,AA,6,26,17,9,26,16,4,20,0.6538461538461539,0.8
440,Springfield Cardinals,2022,12,AA,7,24,36,9,45,17,2,19,0.8,0.8947368421052632
440,Springfield Cardinals,2022,12,AA,8,18,19,6,25,18,7,25,0.76,0.72
440,Springfield Cardinals,2022,12,AA,9,16,34,5,39,10,3,13,0.8717948717948718,0.7692307692307693
443,Peoria Chiefs,2022,13,High-A,4,29,60,11,71,15,10,25,0.8450704225352113,0.6
443,Peoria Chiefs,2022,13,High-A,5,29,46,9,55,17,5,22,0.8363636363636363,0.7727272727272727
443,Peoria Chiefs,2022,13,High-A,6,26,40,0,40,19,7,26,1.0,0.7307692307692307
443,Peoria Chiefs,2022,13,High-A,7,24,15,7,22,27,3,30,0.6818181818181818,0.9
443,Peoria Chiefs,2022,13,High-A,8,26,30,13,43,27,0,27,0.6976744186046512,1.0
443,Peoria Chiefs,2022,13,High-A,9,10,16,3,19,9,2,11,0.8421052631578947,0.8181818181818182
445,Columbus Clippers,2022,11,AAA,6,23,15,7,22,20,5,25,0.6818181818181818,0.8
445,Columbus Clippers,2022,11,AAA,7,24,29,3,32,8,11,19,0.90625,0.42105263157894735
445,Columbus Clippers,2022,11,AAA,8,27,17,5,22,18,2,20,0.7727272727272727,0.9
445,Columbus Clippers,2022,11,AAA,9,33,6,10,16,19,7,26,0.375,0.7307692307692307
448,Hickory Crawdads,2022,13,High-A,4,20,20,12,32,21,5,26,0.625,0.8076923076923077
448,Hickory Crawdads,2022,13,High-A,5,32,29,17,46,20,7,27,0.6304347826086957,0.7407407407407407
448,Hickory Crawdads,2022,13,High-A,6,26,37,10,47,20,5,25,0.7872340425531915,0.8
448,Hickory Crawdads,2022,13,High-A,7,24,28,15,43,30,12,42,0.6511627906976745,0.7142857142857143
448,Hickory Crawdads,2022,13,High-A,8,32,50,13,63,57,15,72,0.7936507936507936,0.7916666666666666
448,Hickory Crawdads,2022,13,High-A,9,13,13,6,19,18,3,21,0.6842105263157895,0.8571428571428571
450,Daytona Tortugas,2022,14,A,4,20,26,10,36,8,5,13,0.7222222222222222,0.6153846153846154
450,Daytona Tortugas,2022,14,A,5,32,40,9,49,22,16,38,0.8163265306122449,0.5789473684210527
450,Daytona Tortugas,2022,14,A,6,41,42,21,63,23,20,43,0.6666666666666666,0.5348837209302325
450,Daytona Tortugas,2022,14,A,7,39,30,8,38,40,14,54,0.7894736842105263,0.7407407407407407
450,Daytona Tortugas,2022,14,A,8,39,24,6,30,26,21,47,0.8,0.5531914893617021
450,Daytona Tortugas,2022,14,A,9,21,18,2,20,8,2,10,0.9,0.8
451,Iowa Cubs,2022,11,AAA,6,26,17,3,20,22,6,28,0.85,0.7857142857142857
451,Iowa Cubs,2022,11,AAA,7,26,14,9,23,31,4,35,0.6086956521739131,0.8857142857142857
451,Iowa Cubs,2022,11,AAA,8,28,20,6,26,34,6,40,0.7692307692307693,0.85
451,Iowa Cubs,2022,11,AAA,9,35,15,8,23,27,14,41,0.6521739130434783,0.6585365853658537
452,Altoona Curve,2022,12,AA,4,23,38,2,40,17,5,22,0.95,0.7727272727272727
452,Altoona Curve,2022,12,AA,5,26,29,11,40,21,6,27,0.725,0.7777777777777778
452,Altoona Curve,2022,12,AA,6,29,47,12,59,18,5,23,0.7966101694915254,0.782608695652174
452,Altoona Curve,2022,12,AA,7,27,38,13,51,19,4,23,0.7450980392156863,0.8260869565217391
452,Altoona Curve,2022,12,AA,8,23,25,7,32,33,9,42,0.78125,0.7857142857142857
452,Altoona Curve,2022,12,AA,9,16,18,3,21,7,4,11,0.8571428571428571,0.6363636363636364
453,Brooklyn Cyclones,2022,13,High-A,4,26,24,11,35,60,8,68,0.6857142857142857,0.8823529411764706
453,Brooklyn Cyclones,2022,13,High-A,5,56,55,11,66,106,17,123,0.8333333333333334,0.8617886178861789
453,Brooklyn Cyclones,2022,13,High-A,6,37,42,9,51,45,12,57,0.8235294117647058,0.7894736842105263
453,Brooklyn Cyclones,2022,13,High-A,7,24,16,15,31,19,12,31,0.5161290322580645,0.6129032258064516
453,Brooklyn Cyclones,2022,13,High-A,8,26,19,2,21,29,11,40,0.9047619047619048,0.725
453,Brooklyn Cyclones,2022,13,High-A,9,13,2,6,8,18,5,23,0.25,0.782608695652174
456,Great Lakes Loons,2022,13,High-A,4,27,15,5,20,30,5,35,0.75,0.8571428571428571
456,Great Lakes Loons,2022,13,High-A,5,31,36,5,41,44,8,52,0.8780487804878049,0.8461538461538461
456,Great Lakes Loons,2022,13,High-A,6,29,9,5,14,37,4,41,0.6428571428571429,0.9024390243902439
456,Great Lakes Loons,2022,13,High-A,7,27,5,4,9,34,5,39,0.5555555555555556,0.8717948717948718
456,Great Lakes Loons,2022,13,High-A,8,29,11,5,16,38,4,42,0.6875,0.9047619047619048
456,Great Lakes Loons,2022,13,High-A,9,13,1,1,2,9,4,13,0.5,0.6923076923076923
459,Dayton Dragons,2022,13,High-A,4,26,31,19,50,19,6,25,0.62,0.76
459,Dayton Dragons,2022,13,High-A,5,47,38,8,46,23,10,33,0.8260869565217391,0.696969696969697
459,Dayton Dragons,2022,13,High-A,6,34,43,5,48,14,16,30,0.8958333333333334,0.4666666666666667
459,Dayton Dragons,2022,13,High-A,7,30,38,6,44,19,16,35,0.8636363636363636,0.5428571428571428
459,Dayton Dragons,2022,13,High-A,8,26,43,9,52,34,10,44,0.8269230769230769,0.7727272727272727
459,Dayton Dragons,2022,13,High-A,9,13,20,17,37,10,3,13,0.5405405405405406,0.7692307692307693
460,Tri-City Dust Devils,2022,13,High-A,4,26,39,14,53,22,5,27,0.7358490566037735,0.8148148148148148
460,Tri-City Dust Devils,2022,13,High-A,5,35,38,6,44,27,11,38,0.8636363636363636,0.7105263157894737
460,Tri-City Dust Devils,2022,13,High-A,6,34,37,11,48,26,11,37,0.7708333333333334,0.7027027027027027
460,Tri-City Dust Devils,2022,13,High-A,7,24,20,9,29,24,13,37,0.6896551724137931,0.6486486486486487
460,Tri-City Dust Devils,2022,13,High-A,8,29,30,9,39,49,6,55,0.7692307692307693,0.8909090909090909
460,Tri-City Dust Devils,2022,13,High-A,9,10,11,4,15,10,6,16,0.7333333333333333,0.625
461,Eugene Emeralds,2022,13,High-A,4,29,20,3,23,42,7,49,0.8695652173913043,0.8571428571428571
461,Eugene Emeralds,2022,13,High-A,5,34,27,5,32,27,10,37,0.84375,0.7297297297297297
461,Eugene Emeralds,2022,13,High-A,6,33,28,11,39,43,10,53,0.717948717948718,0.8113207547169812
461,Eugene Emeralds,2022,13,High-A,7,24,17,4,21,44,9,53,0.8095238095238095,0.8301886792452831
461,Eugene Emeralds,2022,13,High-A,8,26,21,2,23,24,11,35,0.9130434782608695,0.6857142857142857
461,Eugene Emeralds,2022,13,High-A,9,10,19,2,21,7,3,10,0.9047619047619048,0.7
463,New Hampshire Fisher Cats,2022,12,AA,4,32,15,14,29,58,4,62,0.5172413793103449,0.9354838709677419
463,New Hampshire Fisher Cats,2022,12,AA,5,33,19,13,32,49,7,56,0.59375,0.875
463,New Hampshire Fisher Cats,2022,12,AA,6,34,19,8,27,53,14,67,0.7037037037037037,0.7910447761194029
463,New Hampshire Fisher Cats,2022,12,AA,7,24,18,13,31,33,13,46,0.5806451612903226,0.717391304347826
463,New Hampshire Fisher Cats,2022,12,AA,8,18,18,3,21,22,4,26,0.8571428571428571,0.8461538461538461
463,New Hampshire Fisher Cats,2022,12,AA,9,19,15,5,20,24,5,29,0.75,0.8275862068965517
464,FCL Braves,2022,16,Rookie,6,18,24,9,33,21,4,25,0.7272727272727273,0.84
464,FCL Braves,2022,16,Rookie,7,20,27,12,39,32,15,47,0.6923076923076923,0.6808510638297872
464,FCL Braves,2022,16,Rookie,8,23,28,10,38,53,15,68,0.7368421052631579,0.7794117647058824
466,FCL Nationals,2022,16,Rookie,6,21,12,8,20,33,13,46,0.6,0.717391304347826
466,FCL Nationals,2022,16,Rookie,7,30,5,7,12,17,10,27,0.4166666666666667,0.6296296296296297
466,FCL Nationals,2022,16,Rookie,8,21,11,7,18,29,15,44,0.6111111111111112,0.6590909090909091
467,FCL Marlins,2022,16,Rookie,6,19,22,5,27,24,9,33,0.8148148148148148,0.7272727272727273
467,FCL Marlins,2022,16,Rookie,7,23,23,12,35,18,7,25,0.6571428571428571,0.72
467,FCL Marlins,2022,16,Rookie,8,19,24,8,32,29,10,39,0.75,0.7435897435897436
468,FCL Mets,2022,16,Rookie,6,24,43,15,58,35,18,53,0.7413793103448276,0.660377358490566
468,FCL Mets,2022,16,Rookie,7,33,62,11,73,37,25,62,0.8493150684931506,0.5967741935483871
468,FCL Mets,2022,16,Rookie,8,19,25,8,33,31,8,39,0.7575757575757576,0.7948717948717948
469,FCL Phillies,2022,16,Rookie,6,22,16,11,27,24,8,32,0.5925925925925926,0.75
469,FCL Phillies,2022,16,Rookie,7,37,58,13,71,61,20,81,0.8169014084507042,0.7530864197530864
469,FCL Phillies,2022,16,Rookie,8,28,83,14,97,25,20,45,0.8556701030927835,0.5555555555555556
470,FCL Pirates,2022,16,Rookie,6,21,29,17,46,32,16,48,0.6304347826086957,0.6666666666666666
470,FCL Pirates,2022,16,Rookie,7,20,14,13,27,29,11,40,0.5185185185185185,0.725
470,FCL Pirates,2022,16,Rookie,8,28,30,14,44,45,11,56,0.6818181818181818,0.8035714285714286
471,FCL Red Sox,2022,16,Rookie,6,21,32,9,41,20,12,32,0.7804878048780488,0.625
471,FCL Red Sox,2022,16,Rookie,7,20,36,13,49,20,15,35,0.7346938775510204,0.5714285714285714
471,FCL Red Sox,2022,16,Rookie,8,17,33,2,35,14,4,18,0.9428571428571428,0.7777777777777778
473,FCL Tigers,2022,16,Rookie,6,22,39,12,51,30,14,44,0.7647058823529411,0.6818181818181818
473,FCL Tigers,2022,16,Rookie,7,28,20,10,30,38,19,57,0.6666666666666666,0.6666666666666666
473,FCL Tigers,2022,16,Rookie,8,17,11,9,20,27,12,39,0.55,0.6923076923076923
474,FCL Twins,2022,16,Rookie,6,21,21,13,34,39,7,46,0.6176470588235294,0.8478260869565217
474,FCL Twins,2022,16,Rookie,7,20,13,10,23,32,7,39,0.5652173913043478,0.8205128205128205
474,FCL Twins,2022,16,Rookie,8,20,22,7,29,26,4,30,0.7586206896551724,0.8666666666666667
475,FCL Yankees,2022,16,Rookie,6,21,42,11,53,20,12,32,0.7924528301886793,0.625
475,FCL Yankees,2022,16,Rookie,7,35,69,37,106,75,18,93,0.6509433962264151,0.8064516129032258
475,FCL Yankees,2022,16,Rookie,8,28,31,20,51,73,8,81,0.6078431372549019,0.9012345679012346
476,San Jose Giants,2022,14,A,4,20,14,8,22,37,6,43,0.6363636363636364,0.8604651162790697
476,San Jose Giants,2022,14,A,5,26,33,7,40,23,14,37,0.825,0.6216216216216216
476,San Jose Giants,2022,14,A,6,26,36,10,46,24,12,36,0.782608695652174,0.6666666666666666
476,San Jose Giants,2022,14,A,7,24,22,5,27,35,12,47,0.8148148148148148,0.7446808510638298
476,San Jose Giants,2022,14,A,8,26,25,10,35,29,14,43,0.7142857142857143,0.6744186046511628
476,San Jose Giants,2022,14,A,9,10,11,4,15,9,1,10,0.7333333333333333,0.9
477,Greensboro Grasshoppers,2022,13,High-A,4,20,32,9,41,25,4,29,0.7804878048780488,0.8620689655172413
477,Greensboro Grasshoppers,2022,13,High-A,5,30,28,12,40,26,9,35,0.7,0.7428571428571429
477,Greensboro Grasshoppers,2022,13,High-A,6,36,29,20,49,49,10,59,0.5918367346938775,0.8305084745762712
477,Greensboro Grasshoppers,2022,13,High-A,7,25,20,11,31,17,11,28,0.6451612903225806,0.6071428571428571
477,Greensboro Grasshoppers,2022,13,High-A,8,28,32,7,39,17,15,32,0.8205128205128205,0.53125
477,Greensboro Grasshoppers,2022,13,High-A,9,10,10,1,11,12,3,15,0.9090909090909091,0.8
478,Augusta GreenJackets,2022,14,A,4,20,35,10,45,37,6,43,0.7777777777777778,0.8604651162790697
478,Augusta GreenJackets,2022,14,A,5,29,38,10,48,59,6,65,0.7916666666666666,0.9076923076923077
478,Augusta GreenJackets,2022,14,A,6,29,52,16,68,49,4,53,0.7647058823529411,0.9245283018867925
478,Augusta GreenJackets,2022,14,A,7,31,32,10,42,40,10,50,0.7619047619047619,0.8
478,Augusta GreenJackets,2022,14,A,8,31,50,14,64,50,8,58,0.78125,0.8620689655172413
478,Augusta GreenJackets,2022,14,A,9,10,9,8,17,13,4,17,0.5294117647058824,0.7647058823529411
479,Jupiter Hammerheads,2022,14,A,4,20,11,1,12,20,6,26,0.9166666666666666,0.7692307692307693
479,Jupiter Hammerheads,2022,14,A,5,37,32,5,37,33,18,51,0.8648648648648649,0.6470588235294118
479,Jupiter Hammerheads,2022,14,A,6,47,37,4,41,40,32,72,0.9024390243902439,0.5555555555555556
479,Jupiter Hammerheads,2022,14,A,7,43,36,4,40,30,24,54,0.9,0.5555555555555556
479,Jupiter Hammerheads,2022,14,A,8,28,17,7,24,32,7,39,0.7083333333333334,0.8205128205128205
479,Jupiter Hammerheads,2022,14,A,9,10,3,4,7,7,1,8,0.42857142857142855,0.875
481,Lynchburg Hillcats,2022,14,A,4,26,27,6,33,21,1,22,0.8181818181818182,0.9545454545454546
481,Lynchburg Hillcats,2022,14,A,5,39,33,11,44,58,27,85,0.75,0.6823529411764706
481,Lynchburg Hillcats,2022,14,A,6,38,20,18,38,41,22,63,0.5263157894736842,0.6507936507936508
481,Lynchburg Hillcats,2022,14,A,7,24,29,5,34,44,7,51,0.8529411764705882,0.8627450980392157
481,Lynchburg Hillcats,2022,14,A,8,29,24,2,26,39,5,44,0.9230769230769231,0.8863636363636364
481,Lynchburg Hillcats,2022,14,A,9,10,10,3,13,9,1,10,0.7692307692307693,0.9
482,Corpus Christi Hooks,2022,12,AA,4,20,23,3,26,21,4,25,0.8846153846153846,0.84
482,Corpus Christi Hooks,2022,12,AA,5,26,27,5,32,40,7,47,0.84375,0.851063829787234
482,Corpus Christi Hooks,2022,12,AA,6,26,26,9,35,28,14,42,0.7428571428571429,0.6666666666666666
482,Corpus Christi Hooks,2022,12,AA,7,24,22,4,26,17,9,26,0.8461538461538461,0.6538461538461539
482,Corpus Christi Hooks,2022,12,AA,8,18,31,6,37,17,8,25,0.8378378378378378,0.68
482,Corpus Christi Hooks,2022,12,AA,9,25,28,5,33,19,13,32,0.8484848484848485,0.59375
484,Indianapolis Indians,2022,11,AAA,6,24,19,4,23,29,2,31,0.8260869565217391,0.9354838709677419
484,Indianapolis Indians,2022,11,AAA,7,24,11,9,20,17,4,21,0.55,0.8095238095238095
484,Indianapolis Indians,2022,11,AAA,8,31,36,5,41,26,11,37,0.8780487804878049,0.7027027027027027
484,Indianapolis Indians,2022,11,AAA,9,27,32,5,37,37,6,43,0.8648648648648649,0.8604651162790697
485,Down East Wood Ducks,2022,14,A,4,23,41,15,56,27,8,35,0.7321428571428571,0.7714285714285715
485,Down East Wood Ducks,2022,14,A,5,29,60,17,77,35,11,46,0.7792207792207793,0.7608695652173914
485,Down East Wood Ducks,2022,14,A,6,26,74,26,100,22,11,33,0.74,0.6666666666666666
485,Down East Wood Ducks,2022,14,A,7,28,88,18,106,56,10,66,0.8301886792452831,0.8484848484848485
485,Down East Wood Ducks,2022,14,A,8,28,59,20,79,52,4,56,0.7468354430379747,0.9285714285714286
485,Down East Wood Ducks,2022,14,A,9,10,22,7,29,8,4,12,0.7586206896551724,0.6666666666666666
486,Spokane Indians,2022,13,High-A,4,23,43,9,52,16,6,22,0.8269230769230769,0.7272727272727273
486,Spokane Indians,2022,13,High-A,5,35,33,9,42,28,14,42,0.7857142857142857,0.6666666666666666
486,Spokane Indians,2022,13,High-A,6,34,57,17,74,19,14,33,0.7702702702702703,0.5757575757575758
486,Spokane Indians,2022,13,High-A,7,25,43,15,58,24,11,35,0.7413793103448276,0.6857142857142857
486,Spokane Indians,2022,13,High-A,8,28,45,10,55,28,12,40,0.8181818181818182,0.7
486,Spokane Indians,2022,13,High-A,9,10,15,5,20,1,2,3,0.75,0.3333333333333333
487,Kannapolis Cannon Ballers,2022,14,A,4,23,32,6,38,33,9,42,0.8421052631578947,0.7857142857142857
487,Kannapolis Cannon Ballers,2022,14,A,5,32,50,4,54,49,12,61,0.9259259259259259,0.8032786885245902
487,Kannapolis Cannon Ballers,2022,14,A,6,29,30,8,38,56,15,71,0.7894736842105263,0.7887323943661971
487,Kannapolis Cannon Ballers,2022,14,A,7,27,25,8,33,39,8,47,0.7575757575757576,0.8297872340425532
487,Kannapolis Cannon Ballers,2022,14,A,8,26,16,6,22,24,15,39,0.7272727272727273,0.6153846153846154
487,Kannapolis Cannon Ballers,2022,14,A,9,10,10,2,12,10,6,16,0.8333333333333334,0.625
488,Aberdeen IronBirds,2022,13,High-A,4,20,37,3,40,30,4,34,0.925,0.8823529411764706
488,Aberdeen IronBirds,2022,13,High-A,5,36,94,10,104,28,14,42,0.9038461538461539,0.6666666666666666
488,Aberdeen IronBirds,2022,13,High-A,6,30,24,5,29,34,8,42,0.8275862068965517,0.8095238095238095
488,Aberdeen IronBirds,2022,13,High-A,7,34,22,10,32,49,5,54,0.6875,0.9074074074074074
488,Aberdeen IronBirds,2022,13,High-A,8,34,56,10,66,36,6,42,0.8484848484848485,0.8571428571428571
488,Aberdeen IronBirds,2022,13,High-A,9,13,14,5,19,10,3,13,0.7368421052631579,0.7692307692307693
492,Cedar Rapids Kernels,2022,13,High-A,4,26,28,9,37,32,5,37,0.7567567567567568,0.8648648648648649
492,Cedar Rapids Kernels,2022,13,High-A,5,26,24,9,33,23,11,34,0.7272727272727273,0.6764705882352942
492,Cedar Rapids Kernels,2022,13,High-A,6,29,32,9,41,24,12,36,0.7804878048780488,0.6666666666666666
492,Cedar Rapids Kernels,2022,13,High-A,7,27,32,10,42,28,5,33,0.7619047619047619,0.8484848484848485
492,Cedar Rapids Kernels,2022,13,High-A,8,29,48,5,53,47,4,51,0.9056603773584906,0.9215686274509803
492,Cedar Rapids Kernels,2022,13,High-A,9,13,9,2,11,16,12,28,0.8181818181818182,0.5714285714285714
494,Charlotte Knights,2022,11,AAA,6,23,13,10,23,10,9,19,0.5652173913043478,0.5263157894736842
494,Charlotte Knights,2022,11,AAA,7,27,29,8,37,32,10,42,0.7837837837837838,0.7619047619047619
494,Charlotte Knights,2022,11,AAA,8,33,26,16,42,30,5,35,0.6190476190476191,0.8571428571428571
494,Charlotte Knights,2022,11,AAA,9,27,31,10,41,32,7,39,0.7560975609756098,0.8205128205128205
498,Chattanooga Lookouts,2022,12,AA,4,20,28,11,39,12,8,20,0.717948717948718,0.6
498,Chattanooga Lookouts,2022,12,AA,5,26,32,10,42,25,9,34,0.7619047619047619,0.7352941176470589
498,Chattanooga Lookouts,2022,12,AA,6,29,27,7,34,22,11,33,0.7941176470588235,0.6666666666666666
498,Chattanooga Lookouts,2022,12,AA,7,24,28,8,36,33,8,41,0.7777777777777778,0.8048780487804879
498,Chattanooga Lookouts,2022,12,AA,8,27,37,8,45,40,17,57,0.8222222222222222,0.7017543859649122
498,Chattanooga Lookouts,2022,12,AA,9,16,23,7,30,29,8,37,0.7666666666666667,0.7837837837837838
499,Lansing Lugnuts,2022,13,High-A,4,32,11,7,18,33,2,35,0.6111111111111112,0.9428571428571428
499,Lansing Lugnuts,2022,13,High-A,5,32,14,5,19,36,9,45,0.7368421052631579,0.8
499,Lansing Lugnuts,2022,13,High-A,6,29,18,5,23,20,12,32,0.782608695652174,0.625
499,Lansing Lugnuts,2022,13,High-A,7,30,43,6,49,18,5,23,0.8775510204081632,0.782608695652174
499,Lansing Lugnuts,2022,13,High-A,8,26,46,9,55,16,15,31,0.8363636363636363,0.5161290322580645
499,Lansing Lugnuts,2022,13,High-A,9,10,16,3,19,8,11,19,0.8421052631578947,0.42105263157894735
505,Binghamton Rumble Ponies,2022,12,AA,4,24,12,3,15,28,5,33,0.8,0.8484848484848485
505,Binghamton Rumble Ponies,2022,12,AA,5,26,19,5,24,32,8,40,0.7916666666666666,0.8
505,Binghamton Rumble Ponies,2022,12,AA,6,34,32,11,43,31,7,38,0.7441860465116279,0.8157894736842105
505,Binghamton Rumble Ponies,2022,12,AA,7,25,12,5,17,20,11,31,0.7058823529411765,0.6451612903225806
505,Binghamton Rumble Ponies,2022,12,AA,8,21,11,8,19,22,9,31,0.5789473684210527,0.7096774193548387
505,Binghamton Rumble Ponies,2022,12,AA,9,18,13,5,18,15,10,25,0.7222222222222222,0.6
507,St. Lucie Mets,2022,14,A,4,20,17,11,28,17,8,25,0.6071428571428571,0.68
507,St. Lucie Mets,2022,14,A,5,29,30,16,46,35,3,38,0.6521739130434783,0.9210526315789473
507,St. Lucie Mets,2022,14,A,6,29,50,17,67,41,5,46,0.746268656716418,0.8913043478260869
507,St. Lucie Mets,2022,14,A,7,33,22,12,34,51,6,57,0.6470588235294118,0.8947368421052632
507,St. Lucie Mets,2022,14,A,8,29,43,12,55,47,12,59,0.7818181818181819,0.7966101694915254
507,St. Lucie Mets,2022,14,A,9,21,1,2,3,16,2,18,0.3333333333333333,0.8888888888888888
509,Fort Myers Mighty Mussels,2022,14,A,4,24,29,12,41,30,11,41,0.7073170731707317,0.7317073170731707
509,Fort Myers Mighty Mussels,2022,14,A,5,34,76,18,94,29,13,42,0.8085106382978723,0.6904761904761905
509,Fort Myers Mighty Mussels,2022,14,A,6,45,44,27,71,49,13,62,0.6197183098591549,0.7903225806451613
509,Fort Myers Mighty Mussels,2022,14,A,7,42,63,21,84,47,9,56,0.75,0.8392857142857143
509,Fort Myers Mighty Mussels,2022,14,A,8,41,41,12,53,44,20,64,0.7735849056603774,0.6875
509,Fort Myers Mighty Mussels,2022,14,A,9,21,19,2,21,4,1,5,0.9047619047619048,0.8
510,San Antonio Missions,2022,12,AA,4,20,29,5,34,20,4,24,0.8529411764705882,0.8333333333333334
510,San Antonio Missions,2022,12,AA,5,29,49,9,58,17,9,26,0.8448275862068966,0.6538461538461539
510,San Antonio Missions,2022,12,AA,6,29,40,10,50,20,23,43,0.8,0.46511627906976744
510,San Antonio Missions,2022,12,AA,7,24,16,8,24,10,6,16,0.6666666666666666,0.625
510,San Antonio Missions,2022,12,AA,8,18,13,6,19,18,6,24,0.6842105263157895,0.75
510,San Antonio Missions,2022,12,AA,9,19,5,9,14,26,5,31,0.35714285714285715,0.8387096774193549
512,Toledo Mud Hens,2022,11,AAA,6,26,23,9,32,7,6,13,0.71875,0.5384615384615384
512,Toledo Mud Hens,2022,11,AAA,7,31,15,8,23,25,6,31,0.6521739130434783,0.8064516129032258
512,Toledo Mud Hens,2022,11,AAA,8,29,24,6,30,19,10,29,0.8,0.6551724137931034
512,Toledo Mud Hens,2022,11,AAA,9,32,31,10,41,17,12,29,0.7560975609756098,0.5862068965517241
515,Modesto Nuts,2022,14,A,4,20,39,8,47,15,6,21,0.8297872340425532,0.7142857142857143
515,Modesto Nuts,2022,14,A,5,26,28,8,36,33,8,41,0.7777777777777778,0.8048780487804879
515,Modesto Nuts,2022,14,A,6,26,15,14,29,38,9,47,0.5172413793103449,0.8085106382978723
515,Modesto Nuts,2022,14,A,7,24,34,1,35,30,10,40,0.9714285714285714,0.75
515,Modesto Nuts,2022,14,A,8,26,44,7,51,30,8,38,0.8627450980392157,0.7894736842105263
515,Modesto Nuts,2022,14,A,9,10,9,4,13,5,2,7,0.6923076923076923,0.7142857142857143
516,Visalia Rawhide,2022,14,A,4,20,29,10,39,38,7,45,0.7435897435897436,0.8444444444444444
516,Visalia Rawhide,2022,14,A,5,26,43,10,53,51,12,63,0.8113207547169812,0.8095238095238095
516,Visalia Rawhide,2022,14,A,6,29,52,18,70,34,6,40,0.7428571428571429,0.85
516,Visalia Rawhide,2022,14,A,7,24,38,11,49,38,6,44,0.7755102040816326,0.8636363636363636
516,Visalia Rawhide,2022,14,A,8,26,23,15,38,40,11,51,0.6052631578947368,0.7843137254901961
516,Visalia Rawhide,2022,14,A,9,10,2,1,3,16,7,23,0.6666666666666666,0.6956521739130435
521,Myrtle Beach Pelicans,2022,14,A,4,23,24,3,27,40,6,46,0.8888888888888888,0.8695652173913043
521,Myrtle Beach Pelicans,2022,14,A,5,32,44,5,49,37,7,44,0.8979591836734694,0.8409090909090909
521,Myrtle Beach Pelicans,2022,14,A,6,35,11,10,21,36,18,54,0.5238095238095238,0.6666666666666666
521,Myrtle Beach Pelicans,2022,14,A,7,27,27,4,31,44,10,54,0.8709677419354839,0.8148148148148148
521,Myrtle Beach Pelicans,2022,14,A,8,29,35,4,39,61,13,74,0.8974358974358975,0.8243243243243243
521,Myrtle Beach Pelicans,2022,14,A,9,10,10,8,18,22,2,24,0.5555555555555556,0.9166666666666666
522,Reading Fightin Phils,2022,12,AA,4,23,17,7,24,29,6,35,0.7083333333333334,0.8285714285714286
522,Reading Fightin Phils,2022,12,AA,5,32,10,3,13,42,3,45,0.7692307692307693,0.9333333333333333
522,Reading Fightin Phils,2022,12,AA,6,32,10,6,16,46,11,57,0.625,0.8070175438596491
522,Reading Fightin Phils,2022,12,AA,7,24,29,8,37,28,8,36,0.7837837837837838,0.7777777777777778
522,Reading Fightin Phils,2022,12,AA,8,18,23,8,31,19,3,22,0.7419354838709677,0.8636363636363636
522,Reading Fightin Phils,2022,12,AA,9,19,17,5,22,23,4,27,0.7727272727272727,0.8518518518518519
524,Stockton Ports,2022,14,A,4,20,22,6,28,30,10,40,0.7857142857142857,0.75
524,Stockton Ports,2022,14,A,5,26,20,12,32,31,10,41,0.625,0.7560975609756098
524,Stockton Ports,2022,14,A,6,26,19,7,26,38,8,46,0.7307692307692307,0.8260869565217391
524,Stockton Ports,2022,14,A,7,24,20,16,36,35,11,46,0.5555555555555556,0.7608695652173914
524,Stockton Ports,2022,14,A,8,26,26,12,38,35,13,48,0.6842105263157895,0.7291666666666666
524,Stockton Ports,2022,14,A,9,10,5,1,6,16,5,21,0.8333333333333334,0.7619047619047619
526,Rancho Cucamonga Quakes,2022,14,A,4,20,18,3,21,33,9,42,0.8571428571428571,0.7857142857142857
526,Rancho Cucamonga Quakes,2022,14,A,5,26,17,5,22,51,9,60,0.7727272727272727,0.85
526,Rancho Cucamonga Quakes,2022,14,A,6,26,27,3,30,48,10,58,0.9,0.8275862068965517
526,Rancho Cucamonga Quakes,2022,14,A,7,24,21,10,31,46,9,55,0.6774193548387096,0.8363636363636363
526,Rancho Cucamonga Quakes,2022,14,A,8,26,29,8,37,64,9,73,0.7837837837837838,0.8767123287671232
526,Rancho Cucamonga Quakes,2022,14,A,9,13,26,1,27,44,10,54,0.9629629629629629,0.8148148148148148
529,Tacoma Rainiers,2022,11,AAA,6,23,22,6,28,27,12,39,0.7857142857142857,0.6923076923076923
529,Tacoma Rainiers,2022,11,AAA,7,24,25,11,36,22,7,29,0.6944444444444444,0.7586206896551724
529,Tacoma Rainiers,2022,11,AAA,8,28,38,8,46,13,6,19,0.8260869565217391,0.6842105263157895
529,Tacoma Rainiers,2022,11,AAA,9,25,47,9,56,21,2,23,0.8392857142857143,0.9130434782608695
531,Scranton/Wilkes-Barre RailRiders,2022,11,AAA,6,27,30,6,36,24,7,31,0.8333333333333334,0.7741935483870968
531,Scranton/Wilkes-Barre RailRiders,2022,11,AAA,7,27,41,4,45,36,2,38,0.9111111111111111,0.9473684210526315
531,Scranton/Wilkes-Barre RailRiders,2022,11,AAA,8,34,38,11,49,42,12,54,0.7755102040816326,0.7777777777777778
531,Scranton/Wilkes-Barre RailRiders,2022,11,AAA,9,29,34,7,41,38,7,45,0.8292682926829268,0.8444444444444444
533,Worcester Red Sox,2022,11,AAA,6,25,23,11,34,16,6,22,0.6764705882352942,0.7272727272727273
533,Worcester Red Sox,2022,11,AAA,7,27,22,3,25,21,4,25,0.88,0.84
533,Worcester Red Sox,2022,11,AAA,8,26,18,5,23,22,5,27,0.782608695652174,0.8148148148148148
533,Worcester Red Sox,2022,11,AAA,9,28,14,3,17,15,7,22,0.8235294117647058,0.6818181818181818
534,Rochester Red Wings,2022,11,AAA,6,22,25,5,30,28,3,31,0.8333333333333334,0.9032258064516129
534,Rochester Red Wings,2022,11,AAA,7,27,31,5,36,38,5,43,0.8611111111111112,0.8837209302325582
534,Rochester Red Wings,2022,11,AAA,8,26,30,6,36,22,8,30,0.8333333333333334,0.7333333333333333
534,Rochester Red Wings,2022,11,AAA,9,25,23,10,33,20,3,23,0.696969696969697,0.8695652173913043
537,Hudson Valley Renegades,2022,13,High-A,4,23,59,14,73,21,9,30,0.8082191780821918,0.7
537,Hudson Valley Renegades,2022,13,High-A,5,33,49,17,66,51,19,70,0.7424242424242424,0.7285714285714285
537,Hudson Valley Renegades,2022,13,High-A,6,36,54,8,62,40,27,67,0.8709677419354839,0.5970149253731343
537,Hudson Valley Renegades,2022,13,High-A,7,24,42,14,56,24,13,37,0.75,0.6486486486486487
537,Hudson Valley Renegades,2022,13,High-A,8,32,43,6,49,31,5,36,0.8775510204081632,0.8611111111111112
537,Hudson Valley Renegades,2022,13,High-A,9,10,11,2,13,16,3,19,0.8461538461538461,0.8421052631578947
538,Hartford Yard Goats,2022,12,AA,4,29,51,7,58,20,17,37,0.8793103448275862,0.5405405405405406
538,Hartford Yard Goats,2022,12,AA,5,26,44,6,50,13,6,19,0.88,0.6842105263157895
538,Hartford Yard Goats,2022,12,AA,6,29,29,8,37,20,9,29,0.7837837837837838,0.6896551724137931
538,Hartford Yard Goats,2022,12,AA,7,25,22,9,31,28,4,32,0.7096774193548387,0.875
538,Hartford Yard Goats,2022,12,AA,8,18,23,6,29,22,6,28,0.7931034482758621,0.7857142857142857
538,Hartford Yard Goats,2022,12,AA,9,21,15,8,23,23,4,27,0.6521739130434783,0.8518518518518519
540,Frisco RoughRiders,2022,12,AA,4,20,22,4,26,33,1,34,0.8461538461538461,0.9705882352941176
540,Frisco RoughRiders,2022,12,AA,5,30,33,14,47,20,9,29,0.7021276595744681,0.6896551724137931
540,Frisco RoughRiders,2022,12,AA,6,28,32,15,47,29,9,38,0.6808510638297872,0.7631578947368421
540,Frisco RoughRiders,2022,12,AA,7,24,15,6,21,20,10,30,0.7142857142857143,0.6666666666666666
540,Frisco RoughRiders,2022,12,AA,8,18,14,8,22,20,7,27,0.6363636363636364,0.7407407407407407
540,Frisco RoughRiders,2022,12,AA,9,16,24,5,29,26,3,29,0.8275862068965517,0.896551724137931
541,Omaha Storm Chasers,2022,11,AAA,6,24,23,4,27,9,7,16,0.8518518518518519,0.5625
541,Omaha Storm Chasers,2022,11,AAA,7,29,43,7,50,18,8,26,0.86,0.6923076923076923
541,Omaha Storm Chasers,2022,11,AAA,8,29,42,8,50,33,4,37,0.84,0.8918918918918919
541,Omaha Storm Chasers,2022,11,AAA,9,28,33,9,42,21,5,26,0.7857142857142857,0.8076923076923077
546,Portland Sea Dogs,2022,12,AA,4,20,23,6,29,11,6,17,0.7931034482758621,0.6470588235294118
546,Portland Sea Dogs,2022,12,AA,5,32,34,4,38,24,6,30,0.8947368421052632,0.8
546,Portland Sea Dogs,2022,12,AA,6,32,22,13,35,9,8,17,0.6285714285714286,0.5294117647058824
546,Portland Sea Dogs,2022,12,AA,7,24,41,7,48,14,4,18,0.8541666666666666,0.7777777777777778
546,Portland Sea Dogs,2022,12,AA,8,17,19,6,25,19,5,24,0.76,0.7916666666666666
546,Portland Sea Dogs,2022,12,AA,9,16,32,8,40,14,8,22,0.8,0.6363636363636364
547,Harrisburg Senators,2022,12,AA,4,23,19,11,30,28,10,38,0.6333333333333333,0.7368421052631579
547,Harrisburg Senators,2022,12,AA,5,38,21,4,25,30,4,34,0.84,0.8823529411764706
547,Harrisburg Senators,2022,12,AA,6,28,7,11,18,28,8,36,0.3888888888888889,0.7777777777777778
547,Harrisburg Senators,2022,12,AA,7,24,11,8,19,21,5,26,0.5789473684210527,0.8076923076923077
547,Harrisburg Senators,2022,12,AA,8,20,19,7,26,12,9,21,0.7307692307692307,0.5714285714285714
547,Harrisburg Senators,2022,12,AA,9,16,4,6,10,15,5,20,0.4,0.75
548,Delmarva Shorebirds,2022,14,A,4,20,20,2,22,26,7,33,0.9090909090909091,0.7878787878787878
548,Delmarva Shorebirds,2022,14,A,5,26,39,10,49,36,8,44,0.7959183673469388,0.8181818181818182
548,Delmarva Shorebirds,2022,14,A,6,32,24,16,40,55,5,60,0.6,0.9166666666666666
548,Delmarva Shorebirds,2022,14,A,7,27,42,15,57,48,15,63,0.7368421052631579,0.7619047619047619
548,Delmarva Shorebirds,2022,14,A,8,29,25,10,35,55,19,74,0.7142857142857143,0.7432432432432432
548,Delmarva Shorebirds,2022,14,A,9,10,7,3,10,23,6,29,0.7,0.7931034482758621
550,South Bend Cubs,2022,13,High-A,4,23,8,3,11,47,13,60,0.7272727272727273,0.7833333333333333
550,South Bend Cubs,2022,13,High-A,5,29,35,8,43,41,8,49,0.813953488372093,0.8367346938775511
550,South Bend Cubs,2022,13,High-A,6,29,20,20,40,25,4,29,0.5,0.8620689655172413
550,South Bend Cubs,2022,13,High-A,7,24,29,5,34,21,7,28,0.8529411764705882,0.75
550,South Bend Cubs,2022,13,High-A,8,32,43,20,63,21,6,27,0.6825396825396826,0.7777777777777778
550,South Bend Cubs,2022,13,High-A,9,10,4,6,10,15,2,17,0.4,0.8823529411764706
552,Syracuse Mets,2022,11,AAA,6,27,30,5,35,29,6,35,0.8571428571428571,0.8285714285714286
552,Syracuse Mets,2022,11,AAA,7,26,17,6,23,33,10,43,0.7391304347826086,0.7674418604651163
552,Syracuse Mets,2022,11,AAA,8,27,22,10,32,27,12,39,0.6875,0.6923076923076923
552,Syracuse Mets,2022,11,AAA,9,27,25,3,28,23,8,31,0.8928571428571429,0.7419354838709677
553,Tennessee Smokies,2022,12,AA,4,21,9,13,22,30,17,47,0.4090909090909091,0.6382978723404256
553,Tennessee Smokies,2022,12,AA,5,34,19,16,35,48,18,66,0.5428571428571428,0.7272727272727273
553,Tennessee Smokies,2022,12,AA,6,26,21,14,35,39,9,48,0.6,0.8125
553,Tennessee Smokies,2022,12,AA,7,30,45,8,53,50,13,63,0.8490566037735849,0.7936507936507936
553,Tennessee Smokies,2022,12,AA,8,17,26,3,29,19,3,22,0.896551724137931,0.8636363636363636
553,Tennessee Smokies,2022,12,AA,9,22,33,6,39,26,5,31,0.8461538461538461,0.8387096774193549
554,Beloit Sky Carp,2022,13,High-A,4,23,32,12,44,33,11,44,0.7272727272727273,0.75
554,Beloit Sky Carp,2022,13,High-A,5,32,31,13,44,40,7,47,0.7045454545454546,0.851063829787234
554,Beloit Sky Carp,2022,13,High-A,6,26,24,6,30,22,10,32,0.8,0.6875
554,Beloit Sky Carp,2022,13,High-A,7,27,52,3,55,26,10,36,0.9454545454545454,0.7222222222222222
554,Beloit Sky Carp,2022,13,High-A,8,29,26,2,28,25,11,36,0.9285714285714286,0.6944444444444444
554,Beloit Sky Carp,2022,13,High-A,9,10,3,2,5,12,2,14,0.6,0.8571428571428571
556,Nashville Sounds,2022,11,AAA,6,26,21,8,29,28,6,34,0.7241379310344828,0.8235294117647058
556,Nashville Sounds,2022,11,AAA,7,24,25,10,35,19,3,22,0.7142857142857143,0.8636363636363636
556,Nashville Sounds,2022,11,AAA,8,32,66,9,75,28,8,36,0.88,0.7777777777777778
556,Nashville Sounds,2022,11,AAA,9,25,38,6,44,27,7,34,0.8636363636363636,0.7941176470588235
559,Rocket City Trash Pandas,2022,12,AA,4,23,41,17,58,24,7,31,0.7068965517241379,0.7741935483870968
559,Rocket City Trash Pandas,2022,12,AA,5,32,53,12,65,32,12,44,0.8153846153846154,0.7272727272727273
559,Rocket City Trash Pandas,2022,12,AA,6,32,25,15,40,36,6,42,0.625,0.8571428571428571
559,Rocket City Trash Pandas,2022,12,AA,7,24,26,6,32,22,5,27,0.8125,0.8148148148148148
559,Rocket City Trash Pandas,2022,12,AA,8,20,35,8,43,12,5,17,0.813953488372093,0.7058823529411765
559,Rocket City Trash Pandas,2022,12,AA,9,16,15,9,24,10,5,15,0.625,0.6666666666666666
561,Salt Lake Bees,2022,11,AAA,6,26,31,8,39,23,8,31,0.7948717948717948,0.7419354838709677
561,Salt Lake Bees,2022,11,AAA,7,24,25,7,32,21,5,26,0.78125,0.8076923076923077
561,Salt Lake Bees,2022,11,AAA,8,26,14,4,18,26,6,32,0.7777777777777778,0.8125
561,Salt Lake Bees,2022,11,AAA,9,25,38,8,46,21,8,29,0.8260869565217391,0.7241379310344828
564,Jacksonville Jumbo Shrimp,2022,11,AAA,6,23,13,2,15,11,9,20,0.8666666666666667,0.55
564,Jacksonville Jumbo Shrimp,2022,11,AAA,7,24,19,4,23,11,5,16,0.8260869565217391,0.6875
564,Jacksonville Jumbo Shrimp,2022,11,AAA,8,32,21,9,30,42,9,51,0.7,0.8235294117647058
564,Jacksonville Jumbo Shrimp,2022,11,AAA,9,31,41,3,44,26,6,32,0.9318181818181818,0.8125
565,Quad Cities River Bandits,2022,13,High-A,4,26,33,6,39,33,5,38,0.8461538461538461,0.868421052631579
565,Quad Cities River Bandits,2022,13,High-A,5,43,42,9,51,37,5,42,0.8235294117647058,0.8809523809523809
565,Quad Cities River Bandits,2022,13,High-A,6,26,30,14,44,33,6,39,0.6818181818181818,0.8461538461538461
565,Quad Cities River Bandits,2022,13,High-A,7,30,20,6,26,25,5,30,0.7692307692307693,0.8333333333333334
565,Quad Cities River Bandits,2022,13,High-A,8,26,55,2,57,43,10,53,0.9649122807017544,0.8113207547169812
565,Quad Cities River Bandits,2022,13,High-A,9,10,11,2,13,16,4,20,0.8461538461538461,0.8
566,Clearwater Threshers,2022,14,A,4,24,40,12,52,15,15,30,0.7692307692307693,0.5
566,Clearwater Threshers,2022,14,A,5,31,55,19,74,49,17,66,0.7432432432432432,0.7424242424242424
566,Clearwater Threshers,2022,14,A,6,29,36,16,52,29,21,50,0.6923076923076923,0.58
566,Clearwater Threshers,2022,14,A,7,30,14,11,25,34,21,55,0.56,0.6181818181818182
566,Clearwater Threshers,2022,14,A,8,34,35,21,56,32,13,45,0.625,0.7111111111111111
566,Clearwater Threshers,2022,14,A,9,19,2,1,3,21,9,30,0.6666666666666666,0.7
568,Norfolk Tides,2022,11,AAA,6,26,28,9,37,18,3,21,0.7567567567567568,0.8571428571428571
568,Norfolk Tides,2022,11,AAA,7,29,23,9,32,18,9,27,0.71875,0.6666666666666666
568,Norfolk Tides,2022,11,AAA,8,29,36,9,45,29,8,37,0.8,0.7837837837837838
568,Norfolk Tides,2022,11,AAA,9,31,37,12,49,31,11,42,0.7551020408163265,0.7380952380952381
570,Lakeland Flying Tigers,2022,14,A,4,26,18,7,25,19,8,27,0.72,0.7037037037037037
570,Lakeland Flying Tigers,2022,14,A,5,39,32,19,51,46,10,56,0.6274509803921569,0.8214285714285714
570,Lakeland Flying Tigers,2022,14,A,6,45,20,19,39,47,25,72,0.5128205128205128,0.6527777777777778
570,Lakeland Flying Tigers,2022,14,A,7,33,19,6,25,29,8,37,0.76,0.7837837837837838
570,Lakeland Flying Tigers,2022,14,A,8,49,47,11,58,37,14,51,0.8103448275862069,0.7254901960784313
570,Lakeland Flying Tigers,2022,14,A,9,16,8,0,8,3,2,5,1.0,0.6
572,Wisconsin Timber Rattlers,2022,13,High-A,4,29,45,14,59,48,9,57,0.7627118644067796,0.8421052631578947
572,Wisconsin Timber Rattlers,2022,13,High-A,5,26,36,10,46,45,9,54,0.782608695652174,0.8333333333333334
572,Wisconsin Timber Rattlers,2022,13,High-A,6,29,18,10,28,45,6,51,0.6428571428571429,0.8823529411764706
572,Wisconsin Timber Rattlers,2022,13,High-A,7,27,19,8,27,48,9,57,0.7037037037037037,0.8421052631578947
572,Wisconsin Timber Rattlers,2022,13,High-A,8,29,25,5,30,61,7,68,0.8333333333333334,0.8970588235294118
572,Wisconsin Timber Rattlers,2022,13,High-A,9,10,10,2,12,3,1,4,0.8333333333333334,0.75
573,Asheville Tourists,2022,13,High-A,4,20,13,2,15,29,3,32,0.8666666666666667,0.90625
573,Asheville Tourists,2022,13,High-A,5,30,26,12,38,33,10,43,0.6842105263157895,0.7674418604651163
573,Asheville Tourists,2022,13,High-A,6,28,33,8,41,22,5,27,0.8048780487804879,0.8148148148148148
573,Asheville Tourists,2022,13,High-A,7,29,34,9,43,27,11,38,0.7906976744186046,0.7105263157894737
573,Asheville Tourists,2022,13,High-A,8,33,44,19,63,43,11,54,0.6984126984126984,0.7962962962962963
573,Asheville Tourists,2022,13,High-A,9,10,8,1,9,15,1,16,0.8888888888888888,0.9375
574,Arkansas Travelers,2022,12,AA,4,20,26,4,30,28,8,36,0.8666666666666667,0.7777777777777778
574,Arkansas Travelers,2022,12,AA,5,29,18,5,23,36,6,42,0.782608695652174,0.8571428571428571
574,Arkansas Travelers,2022,12,AA,6,29,17,5,22,15,8,23,0.7727272727272727,0.6521739130434783
574,Arkansas Travelers,2022,12,AA,7,24,37,5,42,25,8,33,0.8809523809523809,0.7575757575757576
574,Arkansas Travelers,2022,12,AA,8,18,25,4,29,15,6,21,0.8620689655172413,0.7142857142857143
574,Arkansas Travelers,2022,12,AA,9,16,21,9,30,14,5,19,0.7,0.7368421052631579
580,Winston-Salem Dash,2022,13,High-A,4,20,17,4,21,20,9,29,0.8095238095238095,0.6896551724137931
580,Winston-Salem Dash,2022,13,High-A,5,32,26,2,28,26,14,40,0.9285714285714286,0.65
580,Winston-Salem Dash,2022,13,High-A,6,29,21,9,30,35,8,43,0.7,0.813953488372093
580,Winston-Salem Dash,2022,13,High-A,7,27,30,6,36,33,10,43,0.8333333333333334,0.7674418604651163
580,Winston-Salem Dash,2022,13,High-A,8,26,19,10,29,32,11,43,0.6551724137931034,0.7441860465116279
580,Winston-Salem Dash,2022,13,High-A,9,13,23,6,29,8,5,13,0.7931034482758621,0.6153846153846154
582,West Michigan Whitecaps,2022,13,High-A,4,24,19,4,23,15,7,22,0.8260869565217391,0.6818181818181818
582,West Michigan Whitecaps,2022,13,High-A,5,34,34,7,41,23,10,33,0.8292682926829268,0.696969696969697
582,West Michigan Whitecaps,2022,13,High-A,6,29,27,6,33,22,7,29,0.8181818181818182,0.7586206896551724
582,West Michigan Whitecaps,2022,13,High-A,7,30,21,19,40,31,9,40,0.525,0.775
582,West Michigan Whitecaps,2022,13,High-A,8,29,14,10,24,38,4,42,0.5833333333333334,0.9047619047619048
582,West Michigan Whitecaps,2022,13,High-A,9,10,2,5,7,2,0,2,0.2857142857142857,1.0
584,Fort Wayne TinCaps,2022,13,High-A,4,29,36,5,41,21,10,31,0.8780487804878049,0.6774193548387096
584,Fort Wayne TinCaps,2022,13,High-A,5,32,36,10,46,38,15,53,0.782608695652174,0.7169811320754716
584,Fort Wayne TinCaps,2022,13,High-A,6,26,22,4,26,12,1,13,0.8461538461538461,0.9230769230769231
584,Fort Wayne TinCaps,2022,13,High-A,7,30,35,8,43,27,11,38,0.813953488372093,0.7105263157894737
584,Fort Wayne TinCaps,2022,13,High-A,8,32,21,1,22,31,15,46,0.9545454545454546,0.6739130434782609
584,Fort Wayne TinCaps,2022,13,High-A,9,10,4,1,5,4,3,7,0.8,0.5714285714285714
587,Tampa Tarpons,2022,14,A,4,26,26,12,38,36,10,46,0.6842105263157895,0.782608695652174
587,Tampa Tarpons,2022,14,A,5,34,56,10,66,56,16,72,0.8484848484848485,0.7777777777777778
587,Tampa Tarpons,2022,14,A,6,38,60,17,77,55,24,79,0.7792207792207793,0.6962025316455697
587,Tampa Tarpons,2022,14,A,7,47,72,13,85,69,11,80,0.8470588235294118,0.8625
587,Tampa Tarpons,2022,14,A,8,29,44,16,60,45,16,61,0.7333333333333333,0.7377049180327869
587,Tampa Tarpons,2022,14,A,9,27,10,5,15,13,5,18,0.6666666666666666,0.7222222222222222
599,FCL Orioles,2022,16,Rookie,6,21,19,9,28,30,17,47,0.6785714285714286,0.6382978723404256
599,FCL Orioles,2022,16,Rookie,7,20,23,11,34,28,16,44,0.6764705882352942,0.6363636363636364
599,FCL Orioles,2022,16,Rookie,8,20,26,11,37,15,7,22,0.7027027027027027,0.6818181818181818
600,DSL Angels,2022,16,Rookie,6,24,41,29,70,21,17,38,0.5857142857142857,0.5526315789473685
600,DSL Angels,2022,16,Rookie,7,29,47,17,64,37,29,66,0.734375,0.5606060606060606
600,DSL Angels,2022,16,Rookie,8,19,34,18,52,20,9,29,0.6538461538461539,0.6896551724137931
601,DSL HOU Blue,2022,16,Rookie,6,24,33,19,52,28,16,44,0.6346153846153846,0.6363636363636364
601,DSL HOU Blue,2022,16,Rookie,7,29,53,31,84,50,33,83,0.6309523809523809,0.6024096385542169
601,DSL HOU Blue,2022,16,Rookie,8,25,45,24,69,43,24,67,0.6521739130434783,0.6417910447761194
602,DSL Athletics,2022,16,Rookie,6,18,20,6,26,39,8,47,0.7692307692307693,0.8297872340425532
602,DSL Athletics,2022,16,Rookie,7,27,30,5,35,51,12,63,0.8571428571428571,0.8095238095238095
602,DSL Athletics,2022,16,Rookie,8,21,21,7,28,34,13,47,0.75,0.723404255319149
604,DSL Blue Jays,2022,16,Rookie,6,24,24,6,30,55,11,66,0.8,0.8333333333333334
604,DSL Blue Jays,2022,16,Rookie,7,22,13,3,16,38,3,41,0.8125,0.926829268292683
604,DSL Blue Jays,2022,16,Rookie,8,26,16,16,32,29,6,35,0.5,0.8285714285714286
605,DSL Braves,2022,16,Rookie,6,18,28,11,39,32,16,48,0.717948717948718,0.6666666666666666
605,DSL Braves,2022,16,Rookie,7,29,39,14,53,27,27,54,0.7358490566037735,0.5
605,DSL Braves,2022,16,Rookie,8,25,28,12,40,38,17,55,0.7,0.6909090909090909
607,DSL Brewers 1,2022,16,Rookie,6,20,20,10,30,30,14,44,0.6666666666666666,0.6818181818181818
607,DSL Brewers 1,2022,16,Rookie,7,31,47,16,63,64,20,84,0.746031746031746,0.7619047619047619
607,DSL Brewers 1,2022,16,Rookie,8,26,21,14,35,42,16,58,0.6,0.7241379310344828
608,DSL Cardinals,2022,16,Rookie,6,20,15,6,21,28,17,45,0.7142857142857143,0.6222222222222222
608,DSL Cardinals,2022,16,Rookie,7,26,26,7,33,36,29,65,0.7878787878787878,0.5538461538461539
608,DSL Cardinals,2022,16,Rookie,8,20,32,10,42,30,19,49,0.7619047619047619,0.6122448979591837
609,DSL Cubs Blue,2022,16,Rookie,6,20,42,16,58,38,11,49,0.7241379310344828,0.7755102040816326
609,DSL Cubs Blue,2022,16,Rookie,7,26,56,20,76,52,21,73,0.7368421052631579,0.7123287671232876
609,DSL Cubs Blue,2022,16,Rookie,8,26,37,20,57,60,19,79,0.6491228070175439,0.759493670886076
610,DSL D-backs Black,2022,16,Rookie,6,20,37,19,56,22,8,30,0.6607142857142857,0.7333333333333333
610,DSL D-backs Black,2022,16,Rookie,7,31,48,32,80,32,19,51,0.6,0.6274509803921569
610,DSL D-backs Black,2022,16,Rookie,8,23,32,16,48,24,12,36,0.6666666666666666,0.6666666666666666
611,DSL LAD Bautista,2022,16,Rookie,6,20,35,16,51,29,13,42,0.6862745098039216,0.6904761904761905
611,DSL LAD Bautista,2022,16,Rookie,7,23,35,16,51,25,15,40,0.6862745098039216,0.625
611,DSL LAD Bautista,2022,16,Rookie,8,20,18,11,29,16,8,24,0.6206896551724138,0.6666666666666666
612,DSL LAD Mega,2022,16,Rookie,6,19,7,8,15,42,9,51,0.4666666666666667,0.8235294117647058
612,DSL LAD Mega,2022,16,Rookie,7,28,54,20,74,50,28,78,0.7297297297297297,0.6410256410256411
612,DSL LAD Mega,2022,16,Rookie,8,22,20,12,32,37,10,47,0.625,0.7872340425531915
615,DSL Giants Orange,2022,16,Rookie,6,23,37,15,52,30,21,51,0.7115384615384616,0.5882352941176471
615,DSL Giants Orange,2022,16,Rookie,7,29,40,21,61,46,22,68,0.6557377049180327,0.6764705882352942
615,DSL Giants Orange,2022,16,Rookie,8,23,33,9,42,28,11,39,0.7857142857142857,0.717948717948718
616,DSL CLE Blue,2022,16,Rookie,6,25,31,11,42,40,21,61,0.7380952380952381,0.6557377049180327
616,DSL CLE Blue,2022,16,Rookie,7,39,43,19,62,79,26,105,0.6935483870967742,0.7523809523809524
616,DSL CLE Blue,2022,16,Rookie,8,29,49,14,63,50,23,73,0.7777777777777778,0.684931506849315
618,DSL Mariners,2022,16,Rookie,6,20,23,13,36,35,12,47,0.6388888888888888,0.7446808510638298
618,DSL Mariners,2022,16,Rookie,7,28,36,16,52,57,16,73,0.6923076923076923,0.7808219178082192
618,DSL Mariners,2022,16,Rookie,8,18,9,6,15,38,9,47,0.6,0.8085106382978723
619,DSL Marlins,2022,16,Rookie,6,18,35,8,43,23,9,32,0.813953488372093,0.71875
619,DSL Marlins,2022,16,Rookie,7,28,55,24,79,72,17,89,0.6962025316455697,0.8089887640449438
619,DSL Marlins,2022,16,Rookie,8,20,26,7,33,21,14,35,0.7878787878787878,0.6
620,DSL Mets 1,2022,16,Rookie,6,19,32,13,45,46,23,69,0.7111111111111111,0.6666666666666666
620,DSL Mets 1,2022,16,Rookie,7,30,47,15,62,54,21,75,0.7580645161290323,0.72
620,DSL Mets 1,2022,16,Rookie,8,23,32,17,49,31,9,40,0.6530612244897959,0.775
621,DSL BAL Black,2022,16,Rookie,6,20,30,12,42,27,10,37,0.7142857142857143,0.7297297297297297
621,DSL BAL Black,2022,16,Rookie,7,27,28,12,40,44,16,60,0.7,0.7333333333333333
621,DSL BAL Black,2022,16,Rookie,8,22,22,7,29,25,18,43,0.7586206896551724,0.5813953488372093
622,DSL Padres,2022,16,Rookie,6,22,42,8,50,18,19,37,0.84,0.4864864864864865
622,DSL Padres,2022,16,Rookie,7,27,49,13,62,20,20,40,0.7903225806451613,0.5
622,DSL Padres,2022,16,Rookie,8,20,30,11,41,19,16,35,0.7317073170731707,0.5428571428571428
623,DSL Phillies Red,2022,16,Rookie,6,18,46,17,63,14,12,26,0.7301587301587301,0.5384615384615384
623,DSL Phillies Red,2022,16,Rookie,7,33,78,26,104,33,22,55,0.75,0.6
623,DSL Phillies Red,2022,16,Rookie,8,26,43,18,61,33,15,48,0.7049180327868853,0.6875
624,DSL PIT Black,2022,16,Rookie,6,20,28,17,45,30,20,50,0.6222222222222222,0.6
624,DSL PIT Black,2022,16,Rookie,7,24,43,16,59,48,8,56,0.7288135593220338,0.8571428571428571
624,DSL PIT Black,2022,16,Rookie,8,22,40,11,51,32,15,47,0.7843137254901961,0.6808510638297872
625,DSL TEX Blue,2022,16,Rookie,6,21,35,18,53,28,10,38,0.660377358490566,0.7368421052631579
625,DSL TEX Blue,2022,16,Rookie,7,34,83,35,118,62,20,82,0.7033898305084746,0.7560975609756098
625,DSL TEX Blue,2022,16,Rookie,8,22,47,19,66,25,23,48,0.7121212121212122,0.5208333333333334
626,DSL BOS Blue,2022,16,Rookie,6,20,37,9,46,30,13,43,0.8043478260869565,0.6976744186046512
626,DSL BOS Blue,2022,16,Rookie,7,34,62,20,82,75,14,89,0.7560975609756098,0.8426966292134831
626,DSL BOS Blue,2022,16,Rookie,8,24,51,14,65,46,12,58,0.7846153846153846,0.7931034482758621
627,DSL BOS Red,2022,16,Rookie,6,21,50,13,63,27,18,45,0.7936507936507936,0.6
627,DSL BOS Red,2022,16,Rookie,7,32,53,22,75,32,12,44,0.7066666666666667,0.7272727272727273
627,DSL BOS Red,2022,16,Rookie,8,25,21,11,32,25,22,47,0.65625,0.5319148936170213
628,DSL Reds,2022,16,Rookie,6,21,22,13,35,41,11,52,0.6285714285714286,0.7884615384615384
628,DSL Reds,2022,16,Rookie,7,34,34,12,46,38,20,58,0.7391304347826086,0.6551724137931034
628,DSL Reds,2022,16,Rookie,8,22,12,8,20,21,8,29,0.6,0.7241379310344828
629,DSL Rockies,2022,16,Rookie,6,20,24,14,38,30,3,33,0.631578947368421,0.9090909090909091
629,DSL Rockies,2022,16,Rookie,7,28,48,25,73,34,23,57,0.6575342465753424,0.5964912280701754
629,DSL Rockies,2022,16,Rookie,8,18,35,14,49,30,12,42,0.7142857142857143,0.7142857142857143
630,DSL KC Glass,2022,16,Rookie,6,20,29,13,42,28,14,42,0.6904761904761905,0.6666666666666666
630,DSL KC Glass,2022,16,Rookie,7,32,58,15,73,50,26,76,0.7945205479452054,0.6578947368421053
630,DSL KC Glass,2022,16,Rookie,8,26,28,13,41,38,18,56,0.6829268292682927,0.6785714285714286
631,DSL Tigers 1,2022,16,Rookie,6,18,19,12,31,38,10,48,0.6129032258064516,0.7916666666666666
631,DSL Tigers 1,2022,16,Rookie,7,30,26,18,44,56,17,73,0.5909090909090909,0.7671232876712328
631,DSL Tigers 1,2022,16,Rookie,8,24,39,15,54,37,17,54,0.7222222222222222,0.6851851851851852
632,DSL Twins,2022,16,Rookie,6,22,31,16,47,30,12,42,0.6595744680851063,0.7142857142857143
632,DSL Twins,2022,16,Rookie,7,30,53,38,91,41,19,60,0.5824175824175825,0.6833333333333333
632,DSL Twins,2022,16,Rookie,8,20,43,22,65,28,12,40,0.6615384615384615,0.7
633,DSL White Sox,2022,16,Rookie,6,21,25,13,38,26,21,47,0.6578947368421053,0.5531914893617021
633,DSL White Sox,2022,16,Rookie,7,25,26,19,45,33,23,56,0.5777777777777777,0.5892857142857143
633,DSL White Sox,2022,16,Rookie,8,20,16,11,27,14,14,28,0.5925925925925926,0.5
634,DSL NYY Bombers,2022,16,Rookie,6,21,74,24,98,36,13,49,0.7551020408163265,0.7346938775510204
634,DSL NYY Bombers,2022,16,Rookie,7,26,59,21,80,54,18,72,0.7375,0.75
634,DSL NYY Bombers,2022,16,Rookie,8,19,28,13,41,43,14,57,0.6829268292682927,0.7543859649122807
635,DSL NYY Yankees,2022,16,Rookie,6,21,60,22,82,36,15,51,0.7317073170731707,0.7058823529411765
635,DSL NYY Yankees,2022,16,Rookie,7,23,60,17,77,40,15,55,0.7792207792207793,0.7272727272727273
635,DSL NYY Yankees,2022,16,Rookie,8,22,60,10,70,31,23,54,0.8571428571428571,0.5740740740740741
1270,DSL Nationals,2022,16,Rookie,6,19,20,8,28,18,13,31,0.7142857142857143,0.5806451612903226
1270,DSL Nationals,2022,16,Rookie,7,32,26,15,41,39,16,55,0.6341463414634146,0.7090909090909091
1270,DSL Nationals,2022,16,Rookie,8,18,17,10,27,19,10,29,0.6296296296296297,0.6551724137931034
1350,Northwest Arkansas Naturals,2022,12,AA,4,20,32,5,37,29,2,31,0.8648648648648649,0.9354838709677419
1350,Northwest Arkansas Naturals,2022,12,AA,5,26,31,7,38,22,7,29,0.8157894736842105,0.7586206896551724
1350,Northwest Arkansas Naturals,2022,12,AA,6,29,35,6,41,23,6,29,0.8536585365853658,0.7931034482758621
1350,Northwest Arkansas Naturals,2022,12,AA,7,24,31,9,40,25,9,34,0.775,0.7352941176470589
1350,Northwest Arkansas Naturals,2022,12,AA,8,18,20,9,29,29,3,32,0.6896551724137931,0.90625
1350,Northwest Arkansas Naturals,2022,12,AA,9,19,26,7,33,22,8,30,0.7878787878787878,0.7333333333333333
1370,FCL Cardinals,2022,16,Rookie,6,22,22,13,35,37,17,54,0.6285714285714286,0.6851851851851852
1370,FCL Cardinals,2022,16,Rookie,7,37,23,20,43,53,11,64,0.5348837209302325,0.828125
1370,FCL Cardinals,2022,16,Rookie,8,23,27,14,41,22,7,29,0.6585365853658537,0.7586206896551724
1390,FCL Blue Jays,2022,16,Rookie,6,27,26,16,42,49,16,65,0.6190476190476191,0.7538461538461538
1390,FCL Blue Jays,2022,16,Rookie,7,38,76,18,94,49,21,70,0.8085106382978723,0.7
1390,FCL Blue Jays,2022,16,Rookie,8,17,25,9,34,25,12,37,0.7352941176470589,0.6756756756756757
1410,Lehigh Valley IronPigs,2022,11,AAA,6,22,19,6,25,28,9,37,0.76,0.7567567567567568
1410,Lehigh Valley IronPigs,2022,11,AAA,7,24,29,8,37,25,10,35,0.7837837837837838,0.7142857142857143
1410,Lehigh Valley IronPigs,2022,11,AAA,8,26,26,8,34,29,15,44,0.7647058823529411,0.6590909090909091
1410,Lehigh Valley IronPigs,2022,11,AAA,9,28,23,5,28,21,6,27,0.8214285714285714,0.7777777777777778
1611,DSL Rays,2022,16,Rookie,6,18,34,8,42,26,11,37,0.8095238095238095,0.7027027027027027
1611,DSL Rays,2022,16,Rookie,7,30,61,24,85,48,12,60,0.7176470588235294,0.8
1611,DSL Rays,2022,16,Rookie,8,27,48,22,70,40,10,50,0.6857142857142857,0.8
1956,Somerset Patriots,2022,12,AA,4,20,32,8,40,33,8,41,0.8,0.8048780487804879
1956,Somerset Patriots,2022,12,AA,5,30,55,9,64,29,6,35,0.859375,0.8285714285714286
1956,Somerset Patriots,2022,12,AA,6,31,46,7,53,23,9,32,0.8679245283018868,0.71875
1956,Somerset Patriots,2022,12,AA,7,27,33,8,41,25,7,32,0.8048780487804879,0.78125
1956,Somerset Patriots,2022,12,AA,8,20,16,9,25,12,10,22,0.64,0.5454545454545454
1956,Somerset Patriots,2022,12,AA,9,19,26,4,30,22,5,27,0.8666666666666667,0.8148148148148148
1960,St. Paul Saints,2022,11,AAA,6,23,23,11,34,19,4,23,0.6764705882352942,0.8260869565217391
1960,St. Paul Saints,2022,11,AAA,7,28,26,1,27,26,3,29,0.9629629629629629,0.896551724137931
1960,St. Paul Saints,2022,11,AAA,8,29,38,5,43,25,5,30,0.8837209302325582,0.8333333333333334
1960,St. Paul Saints,2022,11,AAA,9,27,19,4,23,31,7,38,0.8260869565217391,0.8157894736842105
1991,ACL D-backs Black,2022,16,Rookie,6,18,16,3,19,10,4,14,0.8421052631578947,0.7142857142857143
1991,ACL D-backs Black,2022,16,Rookie,7,20,17,7,24,23,12,35,0.7083333333333334,0.6571428571428571
1991,ACL D-backs Black,2022,16,Rookie,8,20,18,5,23,27,9,36,0.782608695652174,0.75
1994,ACL Rockies,2022,16,Rookie,6,18,19,5,24,17,3,20,0.7916666666666666,0.85
1994,ACL Rockies,2022,16,Rookie,7,20,12,12,24,18,6,24,0.5,0.75
1994,ACL Rockies,2022,16,Rookie,8,20,11,9,20,8,2,10,0.55,0.8
1997,ACL White Sox,2022,16,Rookie,6,18,17,2,19,18,1,19,0.8947368421052632,0.9473684210526315
1997,ACL White Sox,2022,16,Rookie,7,20,8,6,14,38,7,45,0.5714285714285714,0.8444444444444444
1997,ACL White Sox,2022,16,Rookie,8,17,15,1,16,22,9,31,0.9375,0.7096774193548387
1998,FCL Astros Blue,2022,16,Rookie,6,21,20,13,33,26,8,34,0.6060606060606061,0.7647058823529411
1998,FCL Astros Blue,2022,16,Rookie,7,30,25,15,40,30,10,40,0.625,0.75
1998,FCL Astros Blue,2022,16,Rookie,8,21,26,14,40,37,14,51,0.65,0.7254901960784313
2000,FCL Astros Orange,2022,16,Rookie,6,23,56,22,78,20,11,31,0.717948717948718,0.6451612903225806
2000,FCL Astros Orange,2022,16,Rookie,7,27,43,11,54,26,13,39,0.7962962962962963,0.6666666666666666
2000,FCL Astros Orange,2022,16,Rookie,8,23,62,14,76,27,11,38,0.8157894736842105,0.7105263157894737
2003,FCL Rays,2022,16,Rookie,6,18,32,9,41,15,10,25,0.7804878048780488,0.6
2003,FCL Rays,2022,16,Rookie,7,20,45,18,63,17,13,30,0.7142857142857143,0.5666666666666667
2003,FCL Rays,2022,16,Rookie,8,28,53,14,67,39,17,56,0.7910447761194029,0.6964285714285714
2101,DSL Brewers 2,2022,16,Rookie,6,19,44,11,55,41,13,54,0.8,0.7592592592592593
2101,DSL Brewers 2,2022,16,Rookie,7,25,55,15,70,48,17,65,0.7857142857142857,0.7384615384615385
2101,DSL Brewers 2,2022,16,Rookie,8,25,33,17,50,38,17,55,0.66,0.6909090909090909
2117,DSL Mets 2,2022,16,Rookie,6,19,34,9,43,46,12,58,0.7906976744186046,0.7931034482758621
2117,DSL Mets 2,2022,16,Rookie,7,25,43,15,58,63,16,79,0.7413793103448276,0.7974683544303798
2117,DSL Mets 2,2022,16,Rookie,8,19,27,11,38,31,11,42,0.7105263157894737,0.7380952380952381
2127,DSL Miami,2022,16,Rookie,6,19,44,12,56,32,11,43,0.7857142857142857,0.7441860465116279
2127,DSL Miami,2022,16,Rookie,7,31,55,15,70,61,24,85,0.7857142857142857,0.7176470588235294
2127,DSL Miami,2022,16,Rookie,8,22,30,9,39,35,12,47,0.7692307692307693,0.7446808510638298
2128,DSL KC Stewart,2022,16,Rookie,6,24,46,12,58,59,15,74,0.7931034482758621,0.7972972972972973
2128,DSL KC Stewart,2022,16,Rookie,7,30,57,18,75,85,11,96,0.76,0.8854166666666666
2128,DSL KC Stewart,2022,16,Rookie,8,27,38,21,59,62,20,82,0.6440677966101694,0.7560975609756098
2131,DSL Colorado,2022,16,Rookie,6,20,19,20,39,18,14,32,0.48717948717948717,0.5625
2131,DSL Colorado,2022,16,Rookie,7,26,34,20,54,27,18,45,0.6296296296296297,0.6
2131,DSL Colorado,2022,16,Rookie,8,17,15,17,32,24,8,32,0.46875,0.75
2132,DSL Tigers 2,2022,16,Rookie,6,19,19,9,28,36,15,51,0.6785714285714286,0.7058823529411765
2132,DSL Tigers 2,2022,16,Rookie,7,55,58,18,76,75,39,114,0.7631578947368421,0.6578947368421053
2132,DSL Tigers 2,2022,16,Rookie,8,38,32,14,46,30,19,49,0.6956521739130435,0.6122448979591837
2134,DSL Giants Black,2022,16,Rookie,6,20,25,13,38,24,17,41,0.6578947368421053,0.5853658536585366
2134,DSL Giants Black,2022,16,Rookie,7,27,38,19,57,56,10,66,0.6666666666666666,0.8484848484848485
2134,DSL Giants Black,2022,16,Rookie,8,19,27,10,37,29,11,40,0.7297297297297297,0.725
2270,DSL Cubs Red,2022,16,Rookie,6,19,27,11,38,42,18,60,0.7105263157894737,0.7
2270,DSL Cubs Red,2022,16,Rookie,7,27,68,20,88,52,25,77,0.7727272727272727,0.6753246753246753
2270,DSL Cubs Red,2022,16,Rookie,8,17,35,17,52,27,12,39,0.6730769230769231,0.6923076923076923
2310,Reno Aces,2022,11,AAA,6,23,31,16,47,17,9,26,0.6595744680851063,0.6538461538461539
2310,Reno Aces,2022,11,AAA,7,24,23,8,31,20,9,29,0.7419354838709677,0.6896551724137931
2310,Reno Aces,2022,11,AAA,8,29,25,6,31,12,9,21,0.8064516129032258,0.5714285714285714
2310,Reno Aces,2022,11,AAA,9,28,15,2,17,16,4,20,0.8823529411764706,0.8
2413,DSL TEX Red,2022,16,Rookie,6,20,38,16,54,45,19,64,0.7037037037037037,0.703125
2413,DSL TEX Red,2022,16,Rookie,7,32,60,32,92,45,22,67,0.6521739130434783,0.6716417910447762
2413,DSL TEX Red,2022,16,Rookie,8,20,37,19,56,31,11,42,0.6607142857142857,0.7380952380952381
2498,Bowling Green Hot Rods,2022,13,High-A,4,20,31,6,37,18,12,30,0.8378378378378378,0.6
2498,Bowling Green Hot Rods,2022,13,High-A,5,37,30,17,47,37,18,55,0.6382978723404256,0.6727272727272727
2498,Bowling Green Hot Rods,2022,13,High-A,6,26,21,8,29,17,6,23,0.7241379310344828,0.7391304347826086
2498,Bowling Green Hot Rods,2022,13,High-A,7,28,30,7,37,25,8,33,0.8108108108108109,0.7575757575757576
2498,Bowling Green Hot Rods,2022,13,High-A,8,28,20,14,34,20,12,32,0.5882352941176471,0.625
2498,Bowling Green Hot Rods,2022,13,High-A,9,10,11,2,13,8,1,9,0.8461538461538461,0.8888888888888888
3130,DSL BAL Orange,2022,16,Rookie,6,21,21,22,43,49,13,62,0.4883720930232558,0.7903225806451613
3130,DSL BAL Orange,2022,16,Rookie,7,29,31,28,59,56,14,70,0.5254237288135594,0.8
3130,DSL BAL Orange,2022,16,Rookie,8,22,36,20,56,35,19,54,0.6428571428571429,0.6481481481481481
3390,Bradenton Marauders,2022,14,A,4,20,12,4,16,17,7,24,0.75,0.7083333333333334
3390,Bradenton Marauders,2022,14,A,5,32,57,11,68,31,7,38,0.8382352941176471,0.8157894736842105
3390,Bradenton Marauders,2022,14,A,6,35,72,24,96,35,7,42,0.75,0.8333333333333334
3390,Bradenton Marauders,2022,14,A,7,39,54,28,82,35,8,43,0.6585365853658537,0.813953488372093
3390,Bradenton Marauders,2022,14,A,8,32,77,29,106,21,13,34,0.7264150943396226,0.6176470588235294
3390,Bradenton Marauders,2022,14,A,9,13,23,9,32,5,3,8,0.71875,0.625
3410,Richmond Flying Squirrels,2022,12,AA,4,23,10,8,18,26,0,26,0.5555555555555556,1.0
3410,Richmond Flying Squirrels,2022,12,AA,5,26,21,4,25,37,5,42,0.84,0.8809523809523809
3410,Richmond Flying Squirrels,2022,12,AA,6,32,21,4,25,17,9,26,0.84,0.6538461538461539
3410,Richmond Flying Squirrels,2022,12,AA,7,27,15,3,18,27,9,36,0.8333333333333334,0.75
3410,Richmond Flying Squirrels,2022,12,AA,8,18,16,6,22,17,7,24,0.7272727272727273,0.7083333333333334
3410,Richmond Flying Squirrels,2022,12,AA,9,16,10,3,13,12,4,16,0.7692307692307693,0.75
3430,ACL Reds,2022,16,Rookie,6,19,21,3,24,28,12,40,0.875,0.7
3430,ACL Reds,2022,16,Rookie,7,24,39,10,49,22,9,31,0.7959183673469388,0.7096774193548387
3430,ACL Reds,2022,16,Rookie,8,21,34,12,46,19,11,30,0.7391304347826086,0.6333333333333333
3705,Columbia Fireflies,2022,14,A,4,23,30,8,38,33,16,49,0.7894736842105263,0.673469387755102
3705,Columbia Fireflies,2022,14,A,5,26,36,6,42,43,16,59,0.8571428571428571,0.7288135593220338
3705,Columbia Fireflies,2022,14,A,6,32,48,17,65,52,13,65,0.7384615384615385,0.8
3705,Columbia Fireflies,2022,14,A,7,27,48,14,62,33,12,45,0.7741935483870968,0.7333333333333333
3705,Columbia Fireflies,2022,14,A,8,26,61,22,83,29,10,39,0.7349397590361446,0.7435897435897436
3705,Columbia Fireflies,2022,14,A,9,10,15,6,21,17,6,23,0.7142857142857143,0.7391304347826086
3712,Fayetteville Woodpeckers,2022,14,A,4,23,41,10,51,36,6,42,0.803921568627451,0.8571428571428571
3712,Fayetteville Woodpeckers,2022,14,A,5,26,36,12,48,59,7,66,0.75,0.8939393939393939
3712,Fayetteville Woodpeckers,2022,14,A,6,29,63,7,70,45,9,54,0.9,0.8333333333333334
3712,Fayetteville Woodpeckers,2022,14,A,7,28,62,14,76,71,12,83,0.8157894736842105,0.8554216867469879
3712,Fayetteville Woodpeckers,2022,14,A,8,31,53,11,64,78,11,89,0.828125,0.8764044943820225
3712,Fayetteville Woodpeckers,2022,14,A,9,10,12,2,14,15,6,21,0.8571428571428571,0.7142857142857143
3898,Wichita Wind Surge,2022,12,AA,4,20,34,7,41,25,4,29,0.8292682926829268,0.8620689655172413
3898,Wichita Wind Surge,2022,12,AA,5,43,86,8,94,54,3,57,0.9148936170212766,0.9473684210526315
3898,Wichita Wind Surge,2022,12,AA,6,37,35,26,61,45,6,51,0.5737704918032787,0.8823529411764706
3898,Wichita Wind Surge,2022,12,AA,7,24,26,6,32,23,10,33,0.8125,0.696969696969697
3898,Wichita Wind Surge,2022,12,AA,8,18,18,9,27,24,6,30,0.6666666666666666,0.8
3898,Wichita Wind Surge,2022,12,AA,9,19,22,4,26,15,6,21,0.8461538461538461,0.7142857142857143
4124,Pensacola Blue Wahoos,2022,12,AA,4,23,37,4,41,33,15,48,0.9024390243902439,0.6875
4124,Pensacola Blue Wahoos,2022,12,AA,5,26,25,10,35,21,7,28,0.7142857142857143,0.75
4124,Pensacola Blue Wahoos,2022,12,AA,6,34,30,3,33,77,9,86,0.9090909090909091,0.8953488372093024
4124,Pensacola Blue Wahoos,2022,12,AA,7,30,43,12,55,44,3,47,0.7818181818181819,0.9361702127659575
4124,Pensacola Blue Wahoos,2022,12,AA,8,24,21,10,31,38,8,46,0.6774193548387096,0.8260869565217391
4124,Pensacola Blue Wahoos,2022,12,AA,9,19,25,9,34,24,5,29,0.7352941176470589,0.8275862068965517
4404,DSL PIT Gold,2022,16,Rookie,6,19,26,8,34,28,16,44,0.7647058823529411,0.6363636363636364
4404,DSL PIT Gold,2022,16,Rookie,7,28,66,16,82,41,19,60,0.8048780487804879,0.6833333333333333
4404,DSL PIT Gold,2022,16,Rookie,8,22,42,13,55,19,10,29,0.7636363636363637,0.6551724137931034
4904,El Paso Chihuahuas,2022,11,AAA,6,26,51,8,59,11,7,18,0.864406779661017,0.6111111111111112
4904,El Paso Chihuahuas,2022,11,AAA,7,27,28,4,32,23,10,33,0.875,0.696969696969697
4904,El Paso Chihuahuas,2022,11,AAA,8,27,17,2,19,17,6,23,0.8947368421052632,0.7391304347826086
4904,El Paso Chihuahuas,2022,11,AAA,9,27,18,4,22,16,5,21,0.8181818181818182,0.7619047619047619
5005,DSL HOU Orange,2022,16,Rookie,6,23,45,19,64,33,8,41,0.703125,0.8048780487804879
5005,DSL HOU Orange,2022,16,Rookie,7,27,70,17,87,61,17,78,0.8045977011494253,0.782051282051282
5005,DSL HOU Orange,2022,16,Rookie,8,31,74,38,112,40,21,61,0.6607142857142857,0.6557377049180327
5015,Biloxi Shuckers,2022,12,AA,4,20,16,5,21,22,5,27,0.7619047619047619,0.8148148148148148
5015,Biloxi Shuckers,2022,12,AA,5,26,36,8,44,32,6,38,0.8181818181818182,0.8421052631578947
5015,Biloxi Shuckers,2022,12,AA,6,26,37,9,46,25,13,38,0.8043478260869565,0.6578947368421053
5015,Biloxi Shuckers,2022,12,AA,7,30,40,3,43,50,13,63,0.9302325581395349,0.7936507936507936
5015,Biloxi Shuckers,2022,12,AA,8,24,22,6,28,32,5,37,0.7857142857142857,0.8648648648648649
5015,Biloxi Shuckers,2022,12,AA,9,16,22,7,29,22,11,33,0.7586206896551724,0.6666666666666666
5085,DSL Phillies White,2022,16,Rookie,6,19,42,12,54,17,14,31,0.7777777777777778,0.5483870967741935
5085,DSL Phillies White,2022,16,Rookie,7,37,58,20,78,34,14,48,0.7435897435897436,0.7083333333333334
5085,DSL Phillies White,2022,16,Rookie,8,29,39,17,56,24,21,45,0.6964285714285714,0.5333333333333333
5086,DSL Tampa Bay,2022,16,Rookie,6,18,29,9,38,26,9,35,0.7631578947368421,0.7428571428571429
5086,DSL Tampa Bay,2022,16,Rookie,7,30,36,21,57,23,13,36,0.631578947368421,0.6388888888888888
5086,DSL Tampa Bay,2022,16,Rookie,8,24,21,17,38,22,17,39,0.5526315789473685,0.5641025641025641
5087,DSL D-backs Red,2022,16,Rookie,6,23,51,14,65,33,11,44,0.7846153846153846,0.75
5087,DSL D-backs Red,2022,16,Rookie,7,28,39,22,61,43,23,66,0.639344262295082,0.6515151515151515
5087,DSL D-backs Red,2022,16,Rookie,8,21,28,4,32,45,11,56,0.875,0.8035714285714286
5368,Amarillo Sod Poodles,2022,12,AA,4,20,26,6,32,17,7,24,0.8125,0.7083333333333334
5368,Amarillo Sod Poodles,2022,12,AA,5,29,30,10,40,11,5,16,0.75,0.6875
5368,Amarillo Sod Poodles,2022,12,AA,6,26,36,13,49,23,14,37,0.7346938775510204,0.6216216216216216
5368,Amarillo Sod Poodles,2022,12,AA,7,24,16,10,26,19,7,26,0.6153846153846154,0.7307692307692307
5368,Amarillo Sod Poodles,2022,12,AA,8,18,18,8,26,12,9,21,0.6923076923076923,0.5714285714285714
5368,Amarillo Sod Poodles,2022,12,AA,9,16,13,4,17,8,4,12,0.7647058823529411,0.6666666666666666
5370,ACL Giants Orange,2022,16,Rookie,6,18,7,5,12,12,5,17,0.5833333333333334,0.7058823529411765
5370,ACL Giants Orange,2022,16,Rookie,7,20,11,6,17,15,7,22,0.6470588235294118,0.6818181818181818
5370,ACL Giants Orange,2022,16,Rookie,8,20,15,1,16,16,1,17,0.9375,0.9411764705882353
5374,ACL Guardians,2022,16,Rookie,6,19,32,11,43,22,5,27,0.7441860465116279,0.8148148148148148
5374,ACL Guardians,2022,16,Rookie,7,24,40,15,55,24,4,28,0.7272727272727273,0.8571428571428571
5374,ACL Guardians,2022,16,Rookie,8,21,27,12,39,26,9,35,0.6923076923076923,0.7428571428571429
5426,ACL Athletics,2022,16,Rookie,6,18,19,8,27,14,7,21,0.7037037037037037,0.6666666666666666
5426,ACL Athletics,2022,16,Rookie,7,20,21,9,30,36,12,48,0.7,0.75
5426,ACL Athletics,2022,16,Rookie,8,17,5,1,6,32,4,36,0.8333333333333334,0.8888888888888888
5427,ACL Dodgers,2022,16,Rookie,6,18,16,1,17,22,8,30,0.9411764705882353,0.7333333333333333
5427,ACL Dodgers,2022,16,Rookie,7,21,22,3,25,21,8,29,0.88,0.7241379310344828
5427,ACL Dodgers,2022,16,Rookie,8,19,22,9,31,31,3,34,0.7096774193548387,0.9117647058823529
5430,ACL Brewers Blue,2022,16,Rookie,6,18,23,8,31,17,6,23,0.7419354838709677,0.7391304347826086
5430,ACL Brewers Blue,2022,16,Rookie,7,20,23,6,29,31,14,45,0.7931034482758621,0.6888888888888889
5430,ACL Brewers Blue,2022,16,Rookie,8,17,16,8,24,24,7,31,0.6666666666666666,0.7741935483870968
5434,Sugar Land Space Cowboys,2022,11,AAA,6,23,26,5,31,19,2,21,0.8387096774193549,0.9047619047619048
5434,Sugar Land Space Cowboys,2022,11,AAA,7,24,25,13,38,26,4,30,0.6578947368421053,0.8666666666666667
5434,Sugar Land Space Cowboys,2022,11,AAA,8,29,30,8,38,20,1,21,0.7894736842105263,0.9523809523809523
5434,Sugar Land Space Cowboys,2022,11,AAA,9,25,25,9,34,7,7,14,0.7352941176470589,0.5
5506,DSL CLE Red,2022,16,Rookie,6,25,37,25,62,63,9,72,0.5967741935483871,0.875
5506,DSL CLE Red,2022,16,Rookie,7,27,57,20,77,54,19,73,0.7402597402597403,0.7397260273972602
5506,DSL CLE Red,2022,16,Rookie,8,26,36,22,58,44,10,54,0.6206896551724138,0.8148148148148148
6038,ACL D-backs Red,2022,16,Rookie,6,18,21,2,23,26,4,30,0.9130434782608695,0.8666666666666667
6038,ACL D-backs Red,2022,16,Rookie,7,20,16,11,27,15,10,25,0.5925925925925926,0.6
6038,ACL D-backs Red,2022,16,Rookie,8,20,14,3,17,11,10,21,0.8235294117647058,0.5238095238095238
