pitcher_id,pitcher_name,season,level_name,opp_1b_2b,opp_2b_3b,games,total_opps,sb,cs,attempts,attempt_rate,success_rate,sb_rate,post2022,year_rel
400072,Juan Antonio Pena,2019,AAA,35,19,15,54,2,1,3,0.0555555555555555,0.6666666666666666,0.037037037037037,0,-3
400141,Horacio Ramirez,2019,AAA,28,6,18,34,1,0,1,0.0294117647058823,1.0,0.0294117647058823,0,-3
407845,Fernando Rodney,2019,AAA,7,3,6,10,2,0,2,0.2,1.0,0.2,0,-3
407878,Jose Valverde,2019,AAA,22,20,26,42,3,1,4,0.0952380952380952,0.75,0.0714285714285714,0,-3
407924,Manny Acosta,2019,AAA,30,15,25,45,1,0,1,0.0222222222222222,1.0,0.0222222222222222,0,-3
408233,Francisco Campos,2019,AAA,25,14,8,39,0,2,2,0.0512820512820512,0.0,0.0,0,-3
425564,Francisco Del Rosario,2019,AAA,48,40,30,88,8,0,8,0.0909090909090909,1.0,0.0909090909090909,0,-3
425656,Wilfredo Ledezma,2019,AAA,5,5,5,10,0,0,0,0.0,,0.0,0,-3
429440,Edgar Gonzalez,2019,AAA,81,44,23,125,2,3,5,0.04,0.4,0.016,0,-3
429719,Edwin Jackson,2019,AAA,16,5,5,21,0,0,0,0.0,,0.0,0,-3
429722,Ervin Santana,2019,AAA,59,27,15,86,5,3,8,0.0930232558139534,0.625,0.0581395348837209,0,-3
429901,Sergio Mitre,2019,AAA,91,40,20,131,14,2,16,0.1221374045801526,0.875,0.1068702290076335,0,-3
429985,Chad Gaudin,2019,AAA,10,6,7,16,2,1,3,0.1875,0.6666666666666666,0.125,0,-3
430613,Ronald Belisario,2019,AAA,47,16,27,63,3,0,3,0.0476190476190476,1.0,0.0476190476190476,0,-3
430634,Sean Burnett,2019,AAA,9,3,5,12,0,0,0,0.0,,0.0,0,-3
434564,Zack Segovia,2019,AAA,46,36,40,82,14,1,15,0.1829268292682926,0.9333333333333332,0.1707317073170731,0,-3
434669,Luis Mendoza,2019,AAA,21,10,5,31,4,0,4,0.1290322580645161,1.0,0.1290322580645161,0,-3
444556,Santiago Gutierrez,2019,AAA,47,14,27,61,2,3,5,0.081967213114754,0.4,0.0327868852459016,0,-3
445060,Ricky Nolasco,2019,AAA,10,10,5,20,2,0,2,0.1,1.0,0.1,0,-3
445994,Alexis Candelario,2019,AAA,42,9,10,51,1,3,4,0.0784313725490196,0.25,0.0196078431372549,0,-3
445995,Arturo Lopez,2019,AAA,81,27,22,108,0,5,5,0.0462962962962962,0.0,0.0,0,-3
446185,Logan Ondrusek,2019,AAA,59,27,17,86,1,2,3,0.0348837209302325,0.3333333333333333,0.0116279069767441,0,-3
446321,Ross Detwiler,2019,AAA,32,12,7,44,2,4,6,0.1363636363636363,0.3333333333333333,0.0454545454545454,0,-3
446861,Guillermo Moscoso,2019,AAA,61,33,21,94,3,4,7,0.0744680851063829,0.4285714285714285,0.0319148936170212,0,-3
447744,Raul Valdes,2019,AAA,9,4,5,13,0,0,0,0.0,,0.0,0,-3
447763,Jesus Adrian Castillo,2019,AAA,39,16,35,55,5,3,8,0.1454545454545454,0.625,0.0909090909090909,0,-3
448159,Manny Parra,2019,AAA,14,10,13,24,1,0,1,0.0416666666666666,1.0,0.0416666666666666,0,-3
448614,Carlos Torres,2019,AAA,39,15,23,54,4,1,5,0.0925925925925925,0.8,0.074074074074074,0,-3
448660,Mark Serrano,2019,AAA,29,15,25,44,3,1,4,0.0909090909090909,0.75,0.0681818181818181,0,-3
448842,Frankie De La Cruz,2019,AAA,87,42,21,129,13,2,15,0.1162790697674418,0.8666666666666667,0.1007751937984496,0,-3
451470,Mauricio Lara,2019,AAA,83,41,22,124,7,1,8,0.064516129032258,0.875,0.0564516129032258,0,-3
451661,Josh Fields,2019,AAA,11,8,11,19,1,1,2,0.1052631578947368,0.5,0.0526315789473684,0,-3
451775,Fernando Rodriguez Jr.,2019,AAA,20,11,14,31,5,0,5,0.1612903225806451,1.0,0.1612903225806451,0,-3
452061,Zach Phillips,2019,AAA,29,10,24,39,1,2,3,0.0769230769230769,0.3333333333333333,0.0256410256410256,0,-3
452676,Mitch Talbot,2019,AAA,34,14,12,48,1,3,4,0.0833333333333333,0.25,0.0208333333333333,0,-3
452743,Jason Urquidez,2019,AAA,4,6,6,10,1,0,1,0.1,1.0,0.1,0,-3
453526,Jesse Estrada,2019,AAA,41,27,21,68,7,1,8,0.1176470588235294,0.875,0.1029411764705882,0,-3
454968,Jose Oyervides,2019,AAA,79,46,24,125,5,5,10,0.08,0.5,0.04,0,-3
455359,Orlando Lara,2019,AAA,63,28,20,91,6,1,7,0.0769230769230769,0.8571428571428571,0.0659340659340659,0,-3
455376,Arcenio Leon,2019,AAA,14,6,12,20,2,0,2,0.1,1.0,0.1,0,-3
455377,Rolando Valdez,2019,AAA,23,21,10,44,7,1,8,0.1818181818181818,0.875,0.1590909090909091,0,-3
455605,J.D. Martin,2019,AAA,32,19,8,51,12,2,14,0.2745098039215686,0.8571428571428571,0.2352941176470588,0,-3
456043,Jonathan Sánchez,2019,AAA,83,41,22,124,8,5,13,0.1048387096774193,0.6153846153846154,0.064516129032258,0,-3
456051,Hector Noesí,2019,AAA,60,20,20,80,4,1,5,0.0625,0.8,0.05,0,-3
456071,Yohan Flande,2019,AAA,31,19,8,50,1,0,1,0.02,1.0,0.02,0,-3
456150,Marco Carrillo,2019,AAA,83,43,21,126,7,4,11,0.0873015873015873,0.6363636363636364,0.0555555555555555,0,-3
456379,Al Alburquerque,2019,AAA,32,14,27,46,4,1,5,0.108695652173913,0.8,0.0869565217391304,0,-3
456387,Ryan Feierabend,2019,AAA,33,19,13,52,3,2,5,0.0961538461538461,0.6,0.0576923076923076,0,-3
456493,Felipe Arredondo,2019,AAA,47,22,32,69,4,0,4,0.0579710144927536,1.0,0.0579710144927536,0,-3
457422,Tim Dillard,2019,AAA,102,54,32,156,5,4,9,0.0576923076923076,0.5555555555555556,0.032051282051282,0,-3
457580,Anthony Carter,2019,AAA,42,21,29,63,0,1,1,0.0158730158730158,0.0,0.0,0,-3
457754,Jon Edwards,2019,AAA,29,14,26,43,6,0,6,0.1395348837209302,1.0,0.1395348837209302,0,-3
457786,Anthony Vasquez,2019,AAA,71,38,24,109,3,1,4,0.036697247706422,0.75,0.0275229357798165,0,-3
458220,Esmerling Vasquez,2019,AAA,17,9,5,26,4,0,4,0.1538461538461538,1.0,0.1538461538461538,0,-3
459372,Jonathan Castellanos,2019,AAA,67,37,23,104,7,5,12,0.1153846153846153,0.5833333333333334,0.0673076923076923,0,-3
459932,Hector Ambriz,2019,AAA,70,33,21,103,2,2,4,0.0388349514563106,0.5,0.0194174757281553,0,-3
460044,Cesar Carrillo,2019,AAA,59,32,18,91,7,1,8,0.0879120879120879,0.875,0.0769230769230769,0,-3
460701,James Russell,2019,AAA,40,17,17,57,2,2,4,0.0701754385964912,0.5,0.0350877192982456,0,-3
461829,Gio González,2019,AAA,16,4,4,20,1,1,2,0.1,0.5,0.05,0,-3
462515,Miguel Socolovich,2019,AAA,32,12,22,44,4,0,4,0.0909090909090909,1.0,0.0909090909090909,0,-3
462945,Cesar Jimenez,2019,AAA,8,6,4,14,0,0,0,0.0,,0.0,0,-3
462956,Felipe Paulino,2019,AAA,17,9,12,26,0,0,0,0.0,,0.0,0,-3
463599,Juan Delgadillo,2019,AAA,8,6,7,14,0,0,0,0.0,,0.0,0,-3
463669,Jorge Castillo,2019,AAA,75,17,23,92,6,7,13,0.1413043478260869,0.4615384615384615,0.0652173913043478,0,-3
465033,Salvador Valdez,2019,AAA,30,19,21,49,0,0,0,0.0,,0.0,0,-3
465038,Alejandro Soto,2019,AAA,46,29,27,75,4,3,7,0.0933333333333333,0.5714285714285714,0.0533333333333333,0,-3
465583,Juan Sandoval,2019,AAA,29,24,30,53,3,0,3,0.0566037735849056,1.0,0.0566037735849056,0,-3
465701,Marlon Arias,2019,AAA,52,31,14,83,4,3,7,0.0843373493975903,0.5714285714285714,0.0481927710843373,0,-3
466457,Edgar Osuna,2019,AAA,67,44,28,111,9,4,13,0.1171171171171171,0.6923076923076923,0.081081081081081,0,-3
466463,Pedro Rodriguez,2019,AAA,33,20,28,53,6,1,7,0.1320754716981132,0.8571428571428571,0.1132075471698113,0,-3
467031,Wirfin Obispo,2019,AAA,40,14,33,54,4,1,5,0.0925925925925925,0.8,0.074074074074074,0,-3
467094,Felix Doubront,2019,AAA,81,40,22,121,3,2,5,0.0413223140495867,0.6,0.024793388429752,0,-3
469134,Esmil Rogers,2019,AAA,71,36,17,107,2,3,5,0.0467289719626168,0.4,0.0186915887850467,0,-3
469191,Carlos Teller,2019,AAA,50,30,20,80,6,3,9,0.1125,0.6666666666666666,0.075,0,-3
471174,Luis Vasquez,2019,AAA,15,10,10,25,3,2,5,0.2,0.6,0.12,0,-3
471822,Jumbo Díaz,2019,AAA,33,20,32,53,5,0,5,0.0943396226415094,1.0,0.0943396226415094,0,-3
472551,Fernando Abad,2019,AAA,31,16,22,47,2,0,2,0.0425531914893617,1.0,0.0425531914893617,0,-3
472906,Pablo Ortega,2019,AAA,7,9,6,16,0,0,0,0.0,,0.0,0,-3
473218,Martin Sotelo,2019,AAA,10,7,9,17,1,0,1,0.0588235294117647,1.0,0.0588235294117647,0,-3
473240,Jose Pina,2019,AAA,43,22,39,65,6,1,7,0.1076923076923077,0.8571428571428571,0.0923076923076923,0,-3
473659,Daniel Guerrero,2019,AAA,48,27,27,75,7,0,7,0.0933333333333333,1.0,0.0933333333333333,0,-3
474039,Pedro Beato,2019,AAA,15,11,15,26,2,0,2,0.0769230769230769,1.0,0.0769230769230769,0,-3
476594,Robert Stock,2019,AAA,26,12,19,38,2,0,2,0.0526315789473684,1.0,0.0526315789473684,0,-3
476595,Lucas Luetge,2019,AAA,32,16,23,48,6,1,7,0.1458333333333333,0.8571428571428571,0.125,0,-3
477003,Jonathon Niese,2019,AAA,54,16,14,70,1,1,2,0.0285714285714285,0.5,0.0142857142857142,0,-3
477361,Rodolfo Aguirre,2019,AAA,6,8,9,14,0,1,1,0.0714285714285714,0.0,0.0,0,-3
477418,Rafael Diaz,2019,AAA,11,8,8,19,1,0,1,0.0526315789473684,1.0,0.0526315789473684,0,-3
477462,Esteban Haro,2019,AAA,35,16,24,51,5,0,5,0.0980392156862745,1.0,0.0980392156862745,0,-3
477479,Jose Manuel Lopez,2019,AAA,39,17,37,56,3,1,4,0.0714285714285714,0.75,0.0535714285714285,0,-3
477557,Francisco Rodriguez,2019,AAA,62,33,16,95,0,3,3,0.031578947368421,0.0,0.0,0,-3
477569,Fernando Salas,2019,AAA,38,19,29,57,1,0,1,0.0175438596491228,1.0,0.0175438596491228,0,-3
477581,Walter Silva,2019,AAA,86,43,23,129,7,2,9,0.0697674418604651,0.7777777777777778,0.0542635658914728,0,-3
477584,Tomas Solis,2019,AAA,47,28,26,75,2,1,3,0.04,0.6666666666666666,0.0266666666666666,0,-3
484132,Thomas Melgarejo,2019,AAA,26,13,21,39,0,0,0,0.0,,0.0,0,-3
487019,Manuel Flores,2019,AAA,66,35,22,101,11,0,11,0.1089108910891089,1.0,0.1089108910891089,0,-3
487675,Edward Paredes,2019,AAA,15,7,11,22,0,0,0,0.0,,0.0,0,-3
488786,Louis Coleman,2019,AAA,9,5,9,14,0,0,0,0.0,,0.0,0,-3
488787,Casey Coleman,2019,AAA,56,25,24,81,6,0,6,0.074074074074074,1.0,0.074074074074074,0,-3
488846,Brian Duensing,2019,AAA,8,8,7,16,1,0,1,0.0625,1.0,0.0625,0,-3
488957,Carlos Hernandez,2019,AAA,47,31,16,78,2,0,2,0.0256410256410256,1.0,0.0256410256410256,0,-3
489189,Josh Outman,2019,AAA,37,15,10,52,9,3,12,0.2307692307692307,0.75,0.173076923076923,0,-3
489201,Roman Pena,2019,AAA,34,21,35,55,1,1,2,0.0363636363636363,0.5,0.0181818181818181,0,-3
489223,Edwin Quirarte,2019,AAA,12,11,12,23,2,1,3,0.1304347826086956,0.6666666666666666,0.0869565217391304,0,-3
489295,Brian Schlitter,2019,AAA,32,14,24,46,1,1,2,0.0434782608695652,0.5,0.0217391304347826,0,-3
491624,César Valdez,2019,AAA,100,23,23,123,4,5,9,0.073170731707317,0.4444444444444444,0.032520325203252,0,-3
491707,Arturo Barradas,2019,AAA,29,17,25,46,1,2,3,0.0652173913043478,0.3333333333333333,0.0217391304347826,0,-3
491708,Arquimedes Caminero,2019,AAA,27,16,23,43,2,0,2,0.0465116279069767,1.0,0.0465116279069767,0,-3
493183,Jin-Woo Kim,2019,AAA,19,12,6,31,4,2,6,0.1935483870967742,0.6666666666666666,0.1290322580645161,0,-3
495561,Oswaldo Martínez,2019,AAA,41,31,28,72,3,0,3,0.0416666666666666,1.0,0.0416666666666666,0,-3
495647,Luis Angel Daniel,2019,AAA,6,4,3,10,0,0,0,0.0,,0.0,0,-3
496073,Daniel Rodriguez,2019,AAA,67,31,22,98,2,8,10,0.1020408163265306,0.2,0.0204081632653061,0,-3
500279,Jonathan Vargas,2019,AAA,52,20,12,72,5,3,8,0.1111111111111111,0.625,0.0694444444444444,0,-3
500610,Deolis Guerra,2019,AAA,29,13,25,42,5,0,5,0.119047619047619,1.0,0.119047619047619,0,-3
500724,JC Ramírez,2019,AAA,33,18,12,51,8,3,11,0.2156862745098039,0.7272727272727273,0.1568627450980392,0,-3
500882,Nestor Molina,2019,AAA,96,57,24,153,6,4,10,0.065359477124183,0.6,0.0392156862745098,0,-3
501170,Adrian Ramirez,2019,AAA,21,12,18,33,3,0,3,0.0909090909090909,1.0,0.0909090909090909,0,-3
501480,Alejandro Martinez,2019,AAA,33,17,28,50,0,2,2,0.04,0.0,0.0,0,-3
501645,Leuris Gomez,2019,AAA,53,33,13,86,14,2,16,0.1860465116279069,0.875,0.1627906976744186,0,-3
501886,Derrick Loop,2019,AAA,42,18,32,60,4,1,5,0.0833333333333333,0.8,0.0666666666666666,0,-3
502004,George Kontos,2019,AAA,37,20,24,57,9,0,9,0.1578947368421052,1.0,0.1578947368421052,0,-3
502083,Zach McAllister,2019,AAA,9,3,6,12,1,1,2,0.1666666666666666,0.5,0.0833333333333333,0,-3
502103,Mike Antonini,2019,AAA,17,7,16,24,0,0,0,0.0,,0.0,0,-3
502130,Dan Runzler,2019,AAA,27,9,14,36,0,0,0,0.0,,0.0,0,-3
502179,Paolo Espino,2019,AAA,47,18,17,65,1,1,2,0.0307692307692307,0.5,0.0153846153846153,0,-3
502212,Austin Bibens-Dirkx,2019,AAA,21,14,8,35,2,1,3,0.0857142857142857,0.6666666666666666,0.0571428571428571,0,-3
502253,Alex Sanabia,2019,AAA,78,52,22,130,10,1,11,0.0846153846153846,0.9090909090909092,0.0769230769230769,0,-3
502304,David Carpenter,2019,AAA,21,7,20,28,3,0,3,0.1071428571428571,1.0,0.1071428571428571,0,-3
502327,Héctor Santiago,2019,AAA,56,24,15,80,9,2,11,0.1375,0.8181818181818182,0.1125,0,-3
502371,Fabian Williamson,2019,AAA,34,19,30,53,0,0,0,0.0,,0.0,0,-3
502462,Ryan Kelly,2019,AAA,20,7,13,27,1,0,1,0.037037037037037,1.0,0.037037037037037,0,-3
502515,Raul Barron,2019,AAA,28,19,30,47,5,1,6,0.1276595744680851,0.8333333333333334,0.1063829787234042,0,-3
502593,Jake Petricka,2019,AAA,25,21,19,46,2,0,2,0.0434782608695652,1.0,0.0434782608695652,0,-3
502695,Ryan Kussmaul,2019,AAA,19,12,6,31,0,0,0,0.0,,0.0,0,-3
503085,Francisco Gil,2019,AAA,11,12,11,23,0,0,0,0.0,,0.0,0,-3
506693,Henderson Alvarez III,2019,AAA,58,28,24,86,3,4,7,0.0813953488372093,0.4285714285714285,0.0348837209302325,0,-3
510552,Ozzie Mendez,2019,AAA,28,10,27,38,4,1,5,0.131578947368421,0.8,0.1052631578947368,0,-3
510554,Andres Ivan Meza,2019,AAA,75,38,20,113,11,1,12,0.1061946902654867,0.9166666666666666,0.0973451327433628,0,-3
511648,Antonio Garzon,2019,AAA,8,2,9,10,0,0,0,0.0,,0.0,0,-3
513569,Benjamin Sandoval,2019,AAA,32,18,22,50,4,2,6,0.12,0.6666666666666666,0.08,0,-3
514390,Marco Tovar,2019,AAA,55,26,17,81,4,2,6,0.074074074074074,0.6666666666666666,0.0493827160493827,0,-3
514668,Alfonso Sanchez,2019,AAA,35,23,21,58,2,0,2,0.0344827586206896,1.0,0.0344827586206896,0,-3
514669,Rafael Martín,2019,AAA,36,24,31,60,5,1,6,0.1,0.8333333333333334,0.0833333333333333,0,-3
514720,Marco Antonio Duarte,2019,AAA,45,27,19,72,6,2,8,0.1111111111111111,0.75,0.0833333333333333,0,-3
514919,Jesus Pirela,2019,AAA,38,12,33,50,1,1,2,0.04,0.5,0.02,0,-3
514923,Omar Bencomo,2019,AAA,56,19,14,75,5,3,8,0.1066666666666666,0.625,0.0666666666666666,0,-3
514981,Diego Moreno,2019,AAA,27,10,5,37,5,0,5,0.1351351351351351,1.0,0.1351351351351351,0,-3
515052,Mayckol Guaipe,2019,AAA,23,11,12,34,2,0,2,0.0588235294117647,1.0,0.0588235294117647,0,-3
515808,Gabriel Garcia,2019,AAA,42,17,11,59,2,0,2,0.0338983050847457,1.0,0.0338983050847457,0,-3
516414,Ariel Peña,2019,AAA,14,11,6,25,1,0,1,0.04,1.0,0.04,0,-3
516589,André Rienzo,2019,AAA,18,17,6,35,5,0,5,0.1428571428571428,1.0,0.1428571428571428,0,-3
516685,Nelson Gonzalez,2019,AAA,35,17,16,52,2,0,2,0.0384615384615384,1.0,0.0384615384615384,0,-3
516769,Jenrry Mejia,2019,AAA,33,21,27,54,7,1,8,0.1481481481481481,0.875,0.1296296296296296,0,-3
516910,Carlos Frías,2019,AAA,26,16,10,42,1,0,1,0.0238095238095238,1.0,0.0238095238095238,0,-3
516937,Charle Rosario,2019,AAA,14,7,3,21,2,1,3,0.1428571428571428,0.6666666666666666,0.0952380952380952,0,-3
517059,Jose De Paula,2019,AAA,72,33,18,105,3,4,7,0.0666666666666666,0.4285714285714285,0.0285714285714285,0,-3
517062,Juan Pablo Oramas,2019,AAA,78,47,23,125,13,3,16,0.128,0.8125,0.104,0,-3
517414,Randall Delgado,2019,AAA,37,16,10,53,3,3,6,0.1132075471698113,0.5,0.0566037735849056,0,-3
517448,Wilfredo Boscan,2019,AAA,64,32,20,96,3,0,3,0.03125,1.0,0.03125,0,-3
517629,Kelvin Marte,2019,AAA,77,31,14,108,0,3,3,0.0277777777777777,0.0,0.0,0,-3
518432,Travis Banwart,2019,AAA,39,13,9,52,1,2,3,0.0576923076923076,0.3333333333333333,0.0192307692307692,0,-3
518435,Manny Barreda,2019,AAA,72,31,23,103,6,4,10,0.0970873786407767,0.6,0.058252427184466,0,-3
518468,Michael Blazek,2019,AAA,29,16,20,45,0,0,0,0.0,,0.0,0,-3
518566,Taylor Cole,2019,AAA,8,9,10,17,1,1,2,0.1176470588235294,0.5,0.0588235294117647,0,-3
518603,Justin De Fratus,2019,AAA,30,16,10,46,2,1,3,0.0652173913043478,0.6666666666666666,0.0434782608695652,0,-3
518693,Sam Freeman,2019,AAA,59,34,30,93,2,0,2,0.021505376344086,1.0,0.021505376344086,0,-3
518748,Justin Grimm,2019,AAA,49,30,43,79,10,0,10,0.1265822784810126,1.0,0.1265822784810126,0,-3
518774,Matt Harvey,2019,AAA,10,12,6,22,2,1,3,0.1363636363636363,0.6666666666666666,0.0909090909090909,0,-3
518927,Tommy Layne,2019,AAA,29,13,20,42,2,0,2,0.0476190476190476,1.0,0.0476190476190476,0,-3
518961,Josh Lueke,2019,AAA,31,19,29,50,1,0,1,0.02,1.0,0.02,0,-3
519076,Jimmy Nelson,2019,AAA,28,11,12,39,6,1,7,0.1794871794871795,0.8571428571428571,0.1538461538461538,0,-3
519166,Neil Ramírez,2019,AAA,9,11,12,20,3,0,3,0.15,1.0,0.15,0,-3
519240,Marc Rzepczynski,2019,AAA,41,18,34,59,0,1,1,0.0169491525423728,0.0,0.0,0,-3
519246,Andres Santiago,2019,AAA,30,12,10,42,1,1,2,0.0476190476190476,0.5,0.0238095238095238,0,-3
519294,Josh Smoker,2019,AAA,12,7,10,19,2,0,2,0.1052631578947368,1.0,0.1052631578947368,0,-3
519296,Forrest Snow,2019,AAA,19,12,6,31,1,0,1,0.032258064516129,1.0,0.032258064516129,0,-3
519301,Sammy Solís,2019,AAA,11,9,11,20,0,0,0,0.0,,0.0,0,-3
519381,Pat Venditte,2019,AAA,21,17,18,38,2,1,3,0.0789473684210526,0.6666666666666666,0.0526315789473684,0,-3
521055,Maikel Cleto,2019,AAA,35,16,28,51,5,0,5,0.0980392156862745,1.0,0.0980392156862745,0,-3
523848,José Domínguez,2019,AAA,29,26,32,55,1,0,1,0.0181818181818181,1.0,0.0181818181818181,0,-3
523989,Rubby De La Rosa,2019,AAA,12,3,9,15,0,1,1,0.0666666666666666,0.0,0.0,0,-3
524788,Antonio Guzman,2019,AAA,42,17,25,59,1,0,1,0.0169491525423728,1.0,0.0169491525423728,0,-3
525734,Gabriel Arias,2019,AAA,48,20,16,68,0,2,2,0.0294117647058823,0.0,0.0,0,-3
525768,Tim Collins,2019,AAA,15,8,13,23,1,1,2,0.0869565217391304,0.5,0.0434782608695652,0,-3
531565,Miguel Mejia,2019,AAA,25,17,16,42,1,0,1,0.0238095238095238,1.0,0.0238095238095238,0,-3
532936,Mario Sanchez,2019,AAA,15,9,4,24,0,0,0,0.0,,0.0,0,-3
534737,Pat Dean,2019,AAA,69,29,18,98,3,0,3,0.0306122448979591,1.0,0.0306122448979591,0,-3
534812,Kevin Quackenbush,2019,AAA,35,19,30,54,5,0,5,0.0925925925925925,1.0,0.0925925925925925,0,-3
534947,Tim Adleman,2019,AAA,55,28,16,83,6,1,7,0.0843373493975903,0.8571428571428571,0.072289156626506,0,-3
540988,Demetrio Gutierrez,2019,AAA,36,20,29,56,2,0,2,0.0357142857142857,1.0,0.0357142857142857,0,-3
541640,Erasmo Ramírez,2019,AAA,72,40,25,112,2,0,2,0.0178571428571428,1.0,0.0178571428571428,0,-3
542098,Luis De La O,2019,AAA,26,24,27,50,3,0,3,0.06,1.0,0.06,0,-3
542278,Fredy Quintero,2019,AAA,39,22,29,61,5,0,5,0.081967213114754,1.0,0.081967213114754,0,-3
542279,Javier Solano,2019,AAA,80,44,24,124,8,6,14,0.1129032258064516,0.5714285714285714,0.064516129032258,0,-3
542289,Daniel Corcino,2019,AAA,71,29,24,100,2,2,4,0.04,0.5,0.02,0,-3
542360,Porfirio Lopez,2019,AAA,7,4,2,11,0,0,0,0.0,,0.0,0,-3
542413,Felipe Gonzalez,2019,AAA,36,22,35,58,7,0,7,0.1206896551724138,1.0,0.1206896551724138,0,-3
542585,José Cisnero,2019,AAA,22,13,16,35,6,0,6,0.1714285714285714,1.0,0.1714285714285714,0,-3
542609,Enrique Burgos,2019,AAA,6,4,8,10,1,1,2,0.2,0.5,0.1,0,-3
542669,Roman Mendez,2019,AAA,39,22,36,61,1,2,3,0.0491803278688524,0.3333333333333333,0.0163934426229508,0,-3
542674,Gonzalez Germen,2019,AAA,15,8,11,23,1,0,1,0.0434782608695652,1.0,0.0434782608695652,0,-3
542857,Fernando Perez-Abreu,2019,AAA,8,3,5,11,0,0,0,0.0,,0.0,0,-3
542866,Austin Adams,2019,AAA,24,15,21,39,1,1,2,0.0512820512820512,0.5,0.0256410256410256,0,-3
542914,Anthony Bass,2019,AAA,7,6,8,13,0,0,0,0.0,,0.0,0,-3
542946,Jeremy Bleich,2019,AAA,37,22,16,59,8,0,8,0.135593220338983,1.0,0.135593220338983,0,-3
542953,Buddy Boshers,2019,AAA,23,12,16,35,1,0,1,0.0285714285714285,1.0,0.0285714285714285,0,-3
543001,Ryan Carpenter,2019,AAA,45,19,14,64,5,1,6,0.09375,0.8333333333333334,0.078125,0,-3
543017,Hunter Cervenka,2019,AAA,41,16,27,57,6,1,7,0.1228070175438596,0.8571428571428571,0.1052631578947368,0,-3
543031,Tyler Cloyd,2019,AAA,50,28,14,78,1,0,1,0.0128205128205128,1.0,0.0128205128205128,0,-3
543056,Danny Coulombe,2019,AAA,23,14,23,37,3,0,3,0.081081081081081,1.0,0.081081081081081,0,-3
543118,Oliver Drake,2019,AAA,14,6,11,20,1,2,3,0.15,0.3333333333333333,0.05,0,-3
543141,Bryan Evans,2019,AAA,23,15,7,38,4,0,4,0.1052631578947368,1.0,0.1052631578947368,0,-3
543169,Brian Flynn,2019,AAA,27,12,10,39,2,0,2,0.0512820512820512,1.0,0.0512820512820512,0,-3
543193,Drew Gagnon,2019,AAA,48,17,14,65,2,0,2,0.0307692307692307,1.0,0.0307692307692307,0,-3
543195,Eddie Gamboa,2019,AAA,8,4,5,12,0,0,0,0.0,,0.0,0,-3
543219,Sean Gilmartin,2019,AAA,31,18,23,49,2,3,5,0.1020408163265306,0.4,0.0408163265306122,0,-3
543258,Preston Guilmet,2019,AAA,27,33,29,60,11,0,11,0.1833333333333333,1.0,0.1833333333333333,0,-3
543261,Jason Gurka,2019,AAA,17,8,13,25,0,0,0,0.0,,0.0,0,-3
543266,Bradin Hagens,2019,AAA,53,26,21,79,3,0,3,0.0379746835443038,1.0,0.0379746835443038,0,-3
543328,David Holman,2019,AAA,41,30,14,71,5,0,5,0.0704225352112676,1.0,0.0704225352112676,0,-3
543331,J.J. Hoover,2019,AAA,72,32,27,104,1,1,2,0.0192307692307692,0.5,0.0096153846153846,0,-3
543343,Danny Hultzen,2019,AAA,6,4,8,10,3,0,3,0.3,1.0,0.3,0,-3
543351,Jay Jackson,2019,AAA,17,23,18,40,7,0,7,0.175,1.0,0.175,0,-3
543456,Kyle Lobstein,2019,AAA,46,24,33,70,2,0,2,0.0285714285714285,1.0,0.0285714285714285,0,-3
543496,Jarret Martin,2019,AAA,8,12,4,20,0,0,0,0.0,,0.0,0,-3
543532,Tim Melville,2019,AAA,72,24,18,96,3,1,4,0.0416666666666666,0.75,0.03125,0,-3
543548,Tommy Milone,2019,AAA,27,12,9,39,4,1,5,0.1282051282051282,0.8,0.1025641025641025,0,-3
543594,Sean Nolin,2019,AAA,43,18,14,61,4,2,6,0.0983606557377049,0.6666666666666666,0.0655737704918032,0,-3
543677,Matt Ramsey,2019,AAA,24,8,20,32,2,1,3,0.09375,0.6666666666666666,0.0625,0,-3
543698,Donn Roach,2019,AAA,79,47,18,126,0,1,1,0.0079365079365079,0.0,0.0,0,-3
543734,Chris Rusin,2019,AAA,65,29,18,94,6,0,6,0.0638297872340425,1.0,0.0638297872340425,0,-3
543776,JB Shuck,2019,AAA,14,8,11,22,2,0,2,0.0909090909090909,1.0,0.0909090909090909,0,-3
543859,Michael Tonkin,2019,AAA,20,8,14,28,2,1,3,0.1071428571428571,0.6666666666666666,0.0714285714285714,0,-3
543901,Ryan Weber,2019,AAA,67,35,16,102,10,0,10,0.0980392156862745,1.0,0.0980392156862745,0,-3
543935,Alex Wilson,2019,AAA,31,16,27,47,2,1,3,0.0638297872340425,0.6666666666666666,0.0425531914893617,0,-3
543942,Rob Wooten,2019,AAA,6,4,3,10,2,0,2,0.2,1.0,0.2,0,-3
544928,Tyler Lyons,2019,AAA,29,17,26,46,4,2,6,0.1304347826086956,0.6666666666666666,0.0869565217391304,0,-3
545064,Jairo Díaz,2019,AAA,11,7,11,18,0,0,0,0.0,,0.0,0,-3
545343,Louis Head,2019,AAA,10,8,7,18,1,1,2,0.1111111111111111,0.5,0.0555555555555555,0,-3
545346,Zach Lee,2019,AAA,75,22,16,97,1,0,1,0.0103092783505154,1.0,0.0103092783505154,0,-3
547001,Cody Poteet,2019,AAA,42,13,10,55,3,2,5,0.0909090909090909,0.6,0.0545454545454545,0,-3
547176,Daniel Camarena,2019,AAA,55,29,18,84,5,2,7,0.0833333333333333,0.7142857142857143,0.0595238095238095,0,-3
547374,Vanny Valenzuela,2019,AAA,12,3,6,15,1,0,1,0.0666666666666666,1.0,0.0666666666666666,0,-3
547749,Junichi Tazawa,2019,AAA,13,6,12,19,3,0,3,0.1578947368421052,1.0,0.1578947368421052,0,-3
547809,Oscar Felix,2019,AAA,14,9,18,23,0,0,0,0.0,,0.0,0,-3
547862,David Reyes,2019,AAA,70,31,26,101,3,1,4,0.0396039603960396,0.75,0.0297029702970297,0,-3
547921,Tiago Da Silva,2019,AAA,75,30,31,105,4,0,4,0.0380952380952381,1.0,0.0380952380952381,0,-3
547977,Reinier Roibal,2019,AAA,43,21,10,64,3,0,3,0.046875,1.0,0.046875,0,-3
548357,Christian Bergman,2019,AAA,14,11,7,25,2,0,2,0.08,1.0,0.08,0,-3
550014,Adrian Garza,2019,AAA,85,45,23,130,13,1,14,0.1076923076923077,0.9285714285714286,0.1,0,-3
550339,Irwin Delgado,2019,AAA,78,32,20,110,8,3,11,0.1,0.7272727272727273,0.0727272727272727,0,-3
550340,Marco Quevedo,2019,AAA,47,17,18,64,3,3,6,0.09375,0.5,0.046875,0,-3
552640,Andrew Kittredge,2019,AAA,16,3,11,19,1,1,2,0.1052631578947368,0.5,0.0526315789473684,0,-3
553831,Edwin Salas,2019,AAA,33,15,23,48,2,1,3,0.0625,0.6666666666666666,0.0416666666666666,0,-3
553868,Norman Elenes,2019,AAA,36,22,34,58,2,1,3,0.0517241379310344,0.6666666666666666,0.0344827586206896,0,-3
553883,Jose Campos,2019,AAA,5,6,9,11,2,0,2,0.1818181818181818,1.0,0.1818181818181818,0,-3
554037,Gabriel Perez,2019,AAA,26,13,7,39,1,2,3,0.0769230769230769,0.3333333333333333,0.0256410256410256,0,-3
554230,Amilcar Gaxiola,2019,AAA,67,33,20,100,8,2,10,0.1,0.8,0.08,0,-3
570488,Phillips Valdez,2019,AAA,66,37,22,103,13,3,16,0.1553398058252427,0.8125,0.1262135922330097,0,-3
570620,Ivan Zavala,2019,AAA,55,18,44,73,5,1,6,0.0821917808219178,0.8333333333333334,0.0684931506849315,0,-3
570664,Carlos Vazquez,2019,AAA,15,9,18,24,1,0,1,0.0416666666666666,1.0,0.0416666666666666,0,-3
570714,César Vargas,2019,AAA,80,41,29,121,2,4,6,0.0495867768595041,0.3333333333333333,0.0165289256198347,0,-3
570810,Lisalverto Bonilla,2019,AAA,10,5,4,15,0,0,0,0.0,,0.0,0,-3
571057,Frank Garces,2019,AAA,101,53,23,154,9,4,13,0.0844155844155844,0.6923076923076923,0.0584415584415584,0,-3
571328,Jovany Lopez,2019,AAA,6,6,9,12,0,0,0,0.0,,0.0,0,-3
571329,Jesus Barraza,2019,AAA,32,12,25,44,2,0,2,0.0454545454545454,1.0,0.0454545454545454,0,-3
571439,R.J. Alvarez,2019,AAA,36,22,32,58,5,1,6,0.1034482758620689,0.8333333333333334,0.0862068965517241,0,-3
571474,DJ Baxendale,2019,AAA,34,18,19,52,4,0,4,0.0769230769230769,1.0,0.0769230769230769,0,-3
571476,Chris Beck,2019,AAA,26,22,23,48,4,0,4,0.0833333333333333,1.0,0.0833333333333333,0,-3
571521,Rex Brothers,2019,AAA,34,19,29,53,2,0,2,0.0377358490566037,1.0,0.0377358490566037,0,-3
571539,Matt Carasiti,2019,AAA,31,17,20,48,4,0,4,0.0833333333333333,1.0,0.0833333333333333,0,-3
571577,Scott Copeland,2019,AAA,98,54,26,152,8,2,10,0.0657894736842105,0.8,0.0526315789473684,0,-3
571616,Matt Dermody,2019,AAA,10,9,11,19,0,0,0,0.0,,0.0,0,-3
571639,Jonathan Dziedzic,2019,AAA,40,17,23,57,8,0,8,0.1403508771929824,1.0,0.1403508771929824,0,-3
571735,David Hale,2019,AAA,27,16,7,43,2,2,4,0.0930232558139534,0.5,0.0465116279069767,0,-3
571800,Drew Hutchison,2019,AAA,97,46,25,143,19,2,21,0.1468531468531468,0.9047619047619048,0.1328671328671328,0,-3
571858,Branden Kline,2019,AAA,16,16,14,32,1,0,1,0.03125,1.0,0.03125,0,-3
571863,Matt Koch,2019,AAA,65,43,21,108,5,1,6,0.0555555555555555,0.8333333333333334,0.0462962962962962,0,-3
571871,Ian Krol,2019,AAA,42,12,30,54,1,0,1,0.0185185185185185,1.0,0.0185185185185185,0,-3
571911,Damien Magnifico,2019,AAA,7,7,6,14,1,0,1,0.0714285714285714,1.0,0.0714285714285714,0,-3
571917,Parker Markel,2019,AAA,22,14,20,36,5,0,5,0.1388888888888889,1.0,0.1388888888888889,0,-3
571939,Trey McNutt,2019,AAA,24,10,19,34,0,0,0,0.0,,0.0,0,-3
571946,Shelby Miller,2019,AAA,17,9,5,26,3,0,3,0.1153846153846153,1.0,0.1153846153846153,0,-3
571948,Hoby Milner,2019,AAA,24,17,24,41,1,1,2,0.048780487804878,0.5,0.024390243902439,0,-3
571951,Bryan Mitchell,2019,AAA,43,27,13,70,6,1,7,0.1,0.8571428571428571,0.0857142857142857,0,-3
571993,Chris Nunn,2019,AAA,25,18,19,43,1,1,2,0.0465116279069767,0.5,0.0232558139534883,0,-3
572021,James Pazos,2019,AAA,49,32,34,81,5,0,5,0.0617283950617283,1.0,0.0617283950617283,0,-3
572025,Miguel Pena,2019,AAA,50,27,21,77,4,0,4,0.0519480519480519,1.0,0.0519480519480519,0,-3
572044,Brooks Pounders,2019,AAA,31,19,29,50,5,1,6,0.12,0.8333333333333334,0.1,0,-3
572064,Jorge Reyes,2019,AAA,16,3,5,19,0,0,0,0.0,,0.0,0,-3
572086,Brady Rodgers,2019,AAA,29,13,9,42,2,2,4,0.0952380952380952,0.5,0.0476190476190476,0,-3
572089,Paco Rodríguez,2019,AAA,18,8,14,26,1,1,2,0.0769230769230769,0.5,0.0384615384615384,0,-3
572096,Trevor Rosenthal,2019,AAA,6,4,4,10,0,0,0,0.0,,0.0,0,-3
572125,Sam Selman,2019,AAA,17,6,17,23,1,0,1,0.0434782608695652,1.0,0.0434782608695652,0,-3
572143,Burch Smith,2019,AAA,59,27,18,86,5,0,5,0.0581395348837209,1.0,0.0581395348837209,0,-3
572177,Nick Struck,2019,AAA,33,16,26,49,2,0,2,0.0408163265306122,1.0,0.0408163265306122,0,-3
572308,José A. Váldez,2019,AAA,69,33,22,102,7,2,9,0.088235294117647,0.7777777777777778,0.0686274509803921,0,-3
572362,Robbie Erlin,2019,AAA,14,6,8,20,2,0,2,0.1,1.0,0.1,0,-3
572371,Tyler Higgins,2019,AAA,23,7,19,30,0,0,0,0.0,,0.0,0,-3
572383,Brian Moran,2019,AAA,32,15,27,47,1,0,1,0.0212765957446808,1.0,0.0212765957446808,0,-3
572403,Drew VerHagen,2019,AAA,33,16,11,49,2,1,3,0.0612244897959183,0.6666666666666666,0.0408163265306122,0,-3
572687,Tristan Archer,2019,AAA,23,12,13,35,0,1,1,0.0285714285714285,0.0,0.0,0,-3
572703,Luke Bard,2019,AAA,20,15,12,35,5,2,7,0.2,0.7142857142857143,0.1428571428571428,0,-3
572943,Jeff Ibarra,2019,AAA,15,9,20,24,1,0,1,0.0416666666666666,1.0,0.0416666666666666,0,-3
572998,Josh Lucas,2019,AAA,19,18,16,37,2,0,2,0.054054054054054,1.0,0.054054054054054,0,-3
573009,Joe Mantiply,2019,AAA,15,15,16,30,3,0,3,0.1,1.0,0.1,0,-3
573046,Mike Morin,2019,AAA,13,1,8,14,3,2,5,0.3571428571428571,0.6,0.2142857142857142,0,-3
573062,Aaron Northcraft,2019,AAA,18,2,14,20,0,0,0,0.0,,0.0,0,-3
573064,Vidal Nuño,2019,AAA,44,29,29,73,3,3,6,0.0821917808219178,0.5,0.0410958904109589,0,-3
573074,R.C. Orlan,2019,AAA,16,9,11,25,2,0,2,0.08,1.0,0.08,0,-3
573127,Zac Rosscup,2019,AAA,15,11,12,26,0,0,0,0.0,,0.0,0,-3
573137,Gerardo Sanchez,2019,AAA,41,19,37,60,0,1,1,0.0166666666666666,0.0,0.0,0,-3
573185,Dan Straily,2019,AAA,27,14,12,41,6,2,8,0.1951219512195122,0.75,0.1463414634146341,0,-3
573204,Caleb Thielbar,2019,AAA,33,17,26,50,2,0,2,0.04,1.0,0.04,0,-3
573589,Michael Ynoa,2019,AAA,17,8,12,25,3,0,3,0.12,1.0,0.12,0,-3
573612,Alejandro Barraza,2019,AAA,12,9,12,21,0,0,0,0.0,,0.0,0,-3
573654,Julian Arballo,2019,AAA,42,20,22,62,1,0,1,0.0161290322580645,1.0,0.0161290322580645,0,-3
573668,Juan Minaya,2019,AAA,23,15,22,38,2,1,3,0.0789473684210526,0.6666666666666666,0.0526315789473684,0,-3
575070,Enderson Franco,2019,AAA,74,38,23,112,7,4,11,0.0982142857142857,0.6363636363636364,0.0625,0,-3
576028,Jose Meraz,2019,AAA,24,5,26,29,0,0,0,0.0,,0.0,0,-3
578910,Logan Duran,2019,AAA,27,14,10,41,2,0,2,0.048780487804878,1.0,0.048780487804878,0,-3
580792,Nick Goody,2019,AAA,13,11,12,24,2,1,3,0.125,0.6666666666666666,0.0833333333333333,0,-3
582494,Robby Scott,2019,AAA,33,16,27,49,2,0,2,0.0408163265306122,1.0,0.0408163265306122,0,-3
584171,Hector Velázquez,2019,AAA,11,3,10,14,2,1,3,0.2142857142857142,0.6666666666666666,0.1428571428571428,0,-3
584176,Andres Avila,2019,AAA,34,12,26,46,1,1,2,0.0434782608695652,0.5,0.0217391304347826,0,-3
584291,Rodolfo Aguilar,2019,AAA,12,10,16,22,0,0,0,0.0,,0.0,0,-3
585132,Raul Carrillo,2019,AAA,118,51,25,169,9,8,17,0.1005917159763313,0.5294117647058824,0.0532544378698224,0,-3
585671,Juan Ramon Noriega,2019,AAA,44,12,38,56,4,0,4,0.0714285714285714,1.0,0.0714285714285714,0,-3
591611,Johan Belisario,2019,AAA,8,5,2,13,0,0,0,0.0,,0.0,0,-3
592093,Ruddy Acosta,2019,AAA,45,19,12,64,4,3,7,0.109375,0.5714285714285714,0.0625,0,-3
592094,Jason Adam,2019,AAA,5,5,7,10,1,0,1,0.1,1.0,0.1,0,-3
592105,Stetson Allie,2019,AAA,29,17,24,46,11,0,11,0.2391304347826087,1.0,0.2391304347826087,0,-3
592107,Tony Amezcua,2019,AAA,27,11,18,38,1,0,1,0.0263157894736842,1.0,0.0263157894736842,0,-3
592170,Parker Bridwell,2019,AAA,78,59,22,137,4,1,5,0.0364963503649635,0.8,0.0291970802919708,0,-3
592229,Dylan Covey,2019,AAA,27,15,11,42,2,0,2,0.0476190476190476,1.0,0.0476190476190476,0,-3
592230,Kaleb Cowart,2019,AAA,17,9,13,26,3,0,3,0.1153846153846153,1.0,0.1153846153846153,0,-3
592233,Stefan Crichton,2019,AAA,38,23,25,61,5,0,5,0.081967213114754,1.0,0.081967213114754,0,-3
592238,Brandon Cumpton,2019,AAA,20,11,6,31,2,1,3,0.0967741935483871,0.6666666666666666,0.064516129032258,0,-3
592244,Logan Darnell,2019,AAA,37,13,10,50,3,0,3,0.06,1.0,0.06,0,-3
592254,José De León,2019,AAA,32,12,14,44,1,0,1,0.0227272727272727,1.0,0.0227272727272727,0,-3
592280,Ryan Eades,2019,AAA,46,21,26,67,5,0,5,0.0746268656716417,1.0,0.0746268656716417,0,-3
592288,Kent Emanuel,2019,AAA,51,33,25,84,1,1,2,0.0238095238095238,0.5,0.0119047619047619,0,-3
592296,John Fasola,2019,AAA,10,10,6,20,0,0,0,0.0,,0.0,0,-3
592306,Conor Fisk,2019,AAA,53,44,28,97,11,0,11,0.1134020618556701,1.0,0.1134020618556701,0,-3
592314,Mike Foltynewicz,2019,AAA,26,21,10,47,1,1,2,0.0425531914893617,0.5,0.0212765957446808,0,-3
592346,Chi Chi González,2019,AAA,76,32,15,108,3,1,4,0.037037037037037,0.75,0.0277777777777777,0,-3
592361,Evan Grills,2019,AAA,29,17,13,46,6,1,7,0.1521739130434782,0.8571428571428571,0.1304347826086956,0,-3
592398,Taylor Hill,2019,AAA,22,11,6,33,4,0,4,0.1212121212121212,1.0,0.1212121212121212,0,-3
592411,Ben Holmes,2019,AAA,23,14,9,37,5,0,5,0.1351351351351351,1.0,0.1351351351351351,0,-3
592438,Chase Johnson,2019,AAA,18,8,7,26,1,0,1,0.0384615384615384,1.0,0.0384615384615384,0,-3
592455,Jake Kalish,2019,AAA,63,24,22,87,5,4,9,0.1034482758620689,0.5555555555555556,0.057471264367816,0,-3
592464,Mike Kickham,2019,AAA,60,34,28,94,6,1,7,0.0744680851063829,0.8571428571428571,0.0638297872340425,0,-3
592527,Michael Mariot,2019,AAA,22,13,8,35,4,0,4,0.1142857142857142,1.0,0.1142857142857142,0,-3
592593,Justin Nicolino,2019,AAA,83,47,24,130,12,3,15,0.1153846153846153,0.8,0.0923076923076923,0,-3
592614,Dillon Overton,2019,AAA,55,41,24,96,11,2,13,0.1354166666666666,0.8461538461538461,0.1145833333333333,0,-3
592630,Ronald Peña,2019,AAA,12,13,10,25,2,0,2,0.08,1.0,0.08,0,-3
592644,Adam Plutko,2019,AAA,6,4,4,10,0,1,1,0.1,0.0,0.0,0,-3
592705,Nick Rumbelow,2019,AAA,28,15,20,43,1,0,1,0.0232558139534883,1.0,0.0232558139534883,0,-3
592741,Chasen Shreve,2019,AAA,28,19,25,47,0,2,2,0.0425531914893617,0.0,0.0,0,-3
592767,Drew Smyly,2019,AAA,5,5,3,10,2,1,3,0.3,0.6666666666666666,0.2,0,-3
592779,Brock Stewart,2019,AAA,57,31,19,88,13,3,16,0.1818181818181818,0.8125,0.1477272727272727,0,-3
592804,Tyler Thornburg,2019,AAA,22,8,16,30,1,1,2,0.0666666666666666,0.5,0.0333333333333333,0,-3
592848,Zack Weiss,2019,AAA,7,10,6,17,1,0,1,0.0588235294117647,1.0,0.0588235294117647,0,-3
592858,Rowan Wick,2019,AAA,15,9,16,24,1,0,1,0.0416666666666666,1.0,0.0416666666666666,0,-3
592865,Taylor Williams,2019,AAA,27,20,25,47,0,0,0,0.0,,0.0,0,-3
592874,Tom Windle,2019,AAA,41,12,27,53,7,0,7,0.1320754716981132,1.0,0.1320754716981132,0,-3
592879,Asher Wojciechowski,2019,AAA,35,15,15,50,2,1,3,0.06,0.6666666666666666,0.04,0,-3
592889,Ernesto Zaragoza,2019,AAA,49,20,11,69,4,1,5,0.072463768115942,0.8,0.0579710144927536,0,-3
593140,Michael Feliz,2019,AAA,8,3,6,11,1,0,1,0.0909090909090909,1.0,0.0909090909090909,0,-3
593163,Carlos Navas,2019,AAA,23,17,12,40,2,1,3,0.075,0.6666666666666666,0.05,0,-3
593340,Joan Gregorio,2019,AAA,18,6,13,24,1,1,2,0.0833333333333333,0.5,0.0416666666666666,0,-3
593574,Luis González,2019,AAA,25,9,17,34,0,1,1,0.0294117647058823,0.0,0.0,0,-3
593594,Octavio Acosta,2019,AAA,107,36,24,143,4,9,13,0.0909090909090909,0.3076923076923077,0.0279720279720279,0,-3
593604,Alberto Baldonado,2019,AAA,17,5,13,22,0,2,2,0.0909090909090909,0.0,0.0,0,-3
593619,Domingo Tapia,2019,AAA,63,31,37,94,13,2,15,0.1595744680851064,0.8666666666666667,0.1382978723404255,0,-3
593679,Gabriel Ynoa,2019,AAA,8,5,3,13,0,0,0,0.0,,0.0,0,-3
594056,Reymin Guduan,2019,AAA,26,13,21,39,1,0,1,0.0256410256410256,1.0,0.0256410256410256,0,-3
594105,Aldo Montes,2019,AAA,64,35,23,99,6,1,7,0.0707070707070707,0.8571428571428571,0.0606060606060606,0,-3
594311,Jandel Gustave,2019,AAA,17,12,17,29,0,0,0,0.0,,0.0,0,-3
594577,Mike Mayers,2019,AAA,10,6,9,16,1,0,1,0.0625,1.0,0.0625,0,-3
594580,Sam Moll,2019,AAA,8,3,4,11,2,1,3,0.2727272727272727,0.6666666666666666,0.1818181818181818,0,-3
594582,Yoanner Negrin,2019,AAA,87,36,24,123,3,2,5,0.040650406504065,0.6,0.024390243902439,0,-3
594736,Cody Anderson,2019,AAA,13,7,5,20,0,2,2,0.1,0.0,0.0,0,-3
594747,Logan Bawcom,2019,AAA,19,11,7,30,2,0,2,0.0666666666666666,1.0,0.0666666666666666,0,-3
594772,Jake Buchanan,2019,AAA,80,44,23,124,3,0,3,0.0241935483870967,1.0,0.0241935483870967,0,-3
594792,Brandon Cunniff,2019,AAA,27,16,19,43,1,2,3,0.0697674418604651,0.3333333333333333,0.0232558139534883,0,-3
594795,Grant Dayton,2019,AAA,7,3,9,10,0,0,0,0.0,,0.0,0,-3
594848,Casey Harman,2019,AAA,37,22,13,59,3,0,3,0.0508474576271186,1.0,0.0508474576271186,0,-3
594891,Aaron Kurcz,2019,AAA,7,4,8,11,0,0,0,0.0,,0.0,0,-3
594902,Ben Lively,2019,AAA,48,20,18,68,3,0,3,0.0441176470588235,1.0,0.0441176470588235,0,-3
594951,Ryan O'Rourke,2019,AAA,43,25,32,68,8,2,10,0.1470588235294117,0.8,0.1176470588235294,0,-3
594965,Daniel Ponce de Leon,2019,AAA,56,13,15,69,6,4,10,0.144927536231884,0.6,0.0869565217391304,0,-3
594985,Ben Rowen,2019,AAA,36,23,24,59,0,1,1,0.0169491525423728,0.0,0.0,0,-3
594987,Casey Sadler,2019,AAA,21,12,10,33,1,0,1,0.0303030303030303,1.0,0.0303030303030303,0,-3
595001,Josh A. Smith,2019,AAA,47,20,12,67,4,2,6,0.0895522388059701,0.6666666666666666,0.0597014925373134,0,-3
595191,Jerad Eickhoff,2019,AAA,7,4,4,11,1,0,1,0.0909090909090909,1.0,0.0909090909090909,0,-3
595234,Justin Haley,2019,AAA,10,6,4,16,0,0,0,0.0,,0.0,0,-3
595255,Mitch Horacek,2019,AAA,14,14,10,28,1,0,1,0.0357142857142857,1.0,0.0357142857142857,0,-3
595260,Dusty Isaacs,2019,AAA,20,14,14,34,4,2,6,0.1764705882352941,0.6666666666666666,0.1176470588235294,0,-3
595263,Mickey Jannis,2019,AAA,10,3,2,13,0,0,0,0.0,,0.0,0,-3
595296,Chris Lee,2019,AAA,35,21,18,56,1,3,4,0.0714285714285714,0.25,0.0178571428571428,0,-3
595297,Nick Lee,2019,AAA,6,6,7,12,0,0,0,0.0,,0.0,0,-3
595307,Seth Maness,2019,AAA,66,42,20,108,5,2,7,0.0648148148148148,0.7142857142857143,0.0462962962962962,0,-3
595345,Steven Okert,2019,AAA,27,20,26,47,2,0,2,0.0425531914893617,1.0,0.0425531914893617,0,-3
595413,Kenneth Sigman,2019,AAA,57,26,17,83,4,1,5,0.0602409638554216,0.8,0.0481927710843373,0,-3
595465,Dan Winkler,2019,AAA,20,14,20,34,0,1,1,0.0294117647058823,0.0,0.0,0,-3
595798,R.J. Alaniz,2019,AAA,29,17,27,46,3,0,3,0.0652173913043478,1.0,0.0652173913043478,0,-3
595881,Tyler Beede,2019,AAA,20,6,6,26,1,0,1,0.0384615384615384,1.0,0.0384615384615384,0,-3
595893,Bryan Brickhouse,2019,AAA,12,7,10,19,1,1,2,0.1052631578947368,0.5,0.0526315789473684,0,-3
595918,A.J. Cole,2019,AAA,8,4,10,12,0,1,1,0.0833333333333333,0.0,0.0,0,-3
595926,Jason Creasy,2019,AAA,20,10,16,30,2,0,2,0.0666666666666666,1.0,0.0666666666666666,0,-3
595928,John Curtiss,2019,AAA,26,16,18,42,3,0,3,0.0714285714285714,1.0,0.0714285714285714,0,-3
595939,Chris Ellis,2019,AAA,54,49,32,103,8,1,9,0.087378640776699,0.8888888888888888,0.0776699029126213,0,-3
596027,Dillon Maples,2019,AAA,29,11,20,40,5,3,8,0.2,0.625,0.125,0,-3
596035,Reggie McClain,2019,AAA,29,15,15,44,3,0,3,0.0681818181818181,1.0,0.0681818181818181,0,-3
596043,Daniel Mengden,2019,AAA,31,16,12,47,4,0,4,0.0851063829787234,1.0,0.0851063829787234,0,-3
596049,Shawn Morimando,2019,AAA,51,20,14,71,4,2,6,0.0845070422535211,0.6666666666666666,0.056338028169014,0,-3
596071,Dillon Peters,2019,AAA,38,20,13,58,0,0,0,0.0,,0.0,0,-3
596074,Bobby Poyner,2019,AAA,30,18,25,48,4,0,4,0.0833333333333333,1.0,0.0833333333333333,0,-3
596082,Jake Reed,2019,AAA,63,29,35,92,4,2,6,0.0652173913043478,0.6666666666666666,0.0434782608695652,0,-3
596101,Justin Shafer,2019,AAA,14,14,13,28,0,0,0,0.0,,0.0,0,-3
596111,Jordan Stephens,2019,AAA,54,31,15,85,4,1,5,0.0588235294117647,0.8,0.0470588235294117,0,-3
596294,Javier Reynoso,2019,AAA,18,7,11,25,1,1,2,0.08,0.5,0.04,0,-3
596295,Austin Gomber,2019,AAA,24,13,8,37,1,3,4,0.1081081081081081,0.25,0.027027027027027,0,-3
596720,Dovydas Neverauskas,2019,AAA,32,15,22,47,6,0,6,0.1276595744680851,1.0,0.1276595744680851,0,-3
597113,DJ Johnson,2019,AAA,31,22,26,53,3,1,4,0.0754716981132075,0.75,0.0566037735849056,0,-3
598271,Brian Johnson,2019,AAA,11,3,6,14,2,1,3,0.2142857142857142,0.6666666666666666,0.1428571428571428,0,-3
598286,Nick Ramirez,2019,AAA,7,4,2,11,2,0,2,0.1818181818181818,1.0,0.1818181818181818,0,-3
598718,Terance Marin,2019,AAA,67,42,17,109,4,2,6,0.055045871559633,0.6666666666666666,0.036697247706422,0,-3
599093,Luis Heredia,2019,AAA,22,19,17,41,0,0,0,0.0,,0.0,0,-3
599644,Josh Tols,2019,AAA,18,14,16,32,4,1,5,0.15625,0.8,0.125,0,-3
600011,Daniel McGrath,2019,AAA,9,4,2,13,0,2,2,0.1538461538461538,0.0,0.0,0,-3
600355,Tyler Herb,2019,AAA,68,27,16,95,12,3,15,0.1578947368421052,0.8,0.1263157894736842,0,-3
600470,Hector Silvestre,2019,AAA,25,13,16,38,3,1,4,0.1052631578947368,0.75,0.0789473684210526,0,-3
600887,Miguel Del Pozo,2019,AAA,33,19,28,52,7,1,8,0.1538461538461538,0.875,0.1346153846153846,0,-3
600914,Ulises Joaquin,2019,AAA,9,4,8,13,1,0,1,0.0769230769230769,1.0,0.0769230769230769,0,-3
600921,Andrés Machado,2019,AAA,51,18,33,69,6,0,6,0.0869565217391304,1.0,0.0869565217391304,0,-3
600944,David Paulino,2019,AAA,19,6,7,25,1,0,1,0.04,1.0,0.04,0,-3
600968,Randy Rosario,2019,AAA,31,21,24,52,1,0,1,0.0192307692307692,1.0,0.0192307692307692,0,-3
600986,Thyago Vieira,2019,AAA,25,23,27,48,3,0,3,0.0625,1.0,0.0625,0,-3
601713,Nick Pivetta,2019,AAA,21,12,9,33,7,0,7,0.2121212121212121,1.0,0.2121212121212121,0,-3
601978,Fabian Cota,2019,AAA,27,16,23,43,0,1,1,0.0232558139534883,0.0,0.0,0,-3
602345,Linder Castro,2019,AAA,59,29,41,88,6,3,9,0.1022727272727272,0.6666666666666666,0.0681818181818181,0,-3
602513,Gonzalo Sanudo,2019,AAA,31,17,24,48,4,2,6,0.125,0.6666666666666666,0.0833333333333333,0,-3
604596,Alex Delgado,2019,AAA,89,48,25,137,6,3,9,0.0656934306569343,0.6666666666666666,0.0437956204379562,0,-3
605138,Wes Benjamin,2019,AAA,79,40,26,119,3,3,6,0.0504201680672268,0.5,0.0252100840336134,0,-3
605143,Ray Black,2019,AAA,17,9,18,26,2,2,4,0.1538461538461538,0.5,0.0769230769230769,0,-3
605155,Colten Brewer,2019,AAA,12,5,7,17,2,0,2,0.1176470588235294,1.0,0.1176470588235294,0,-3
605191,Joshua Corrales,2019,AAA,33,14,24,47,2,0,2,0.0425531914893617,1.0,0.0425531914893617,0,-3
605194,Jharel Cotton,2019,AAA,11,9,10,20,5,0,5,0.25,1.0,0.25,0,-3
605218,Carl Edwards Jr.,2019,AAA,9,5,8,14,1,0,1,0.0714285714285714,1.0,0.0714285714285714,0,-3
605226,Andrew Faulkner,2019,AAA,10,5,11,15,0,1,1,0.0666666666666666,0.0,0.0,0,-3
605255,Brett Graves,2019,AAA,14,5,10,19,1,0,1,0.0526315789473684,1.0,0.0526315789473684,0,-3
605260,Taylor Guerrieri,2019,AAA,27,21,18,48,13,1,14,0.2916666666666667,0.9285714285714286,0.2708333333333333,0,-3
605276,David Hess,2019,AAA,27,9,11,36,0,0,0,0.0,,0.0,0,-3
605280,Clay Holmes,2019,AAA,17,6,10,23,1,0,1,0.0434782608695652,1.0,0.0434782608695652,0,-3
605288,Adrian Houser,2019,AAA,9,4,4,13,0,0,0,0.0,,0.0,0,-3
605301,Williams Jerez,2019,AAA,39,16,28,55,5,0,5,0.0909090909090909,1.0,0.0909090909090909,0,-3
605441,Yacksel Ríos,2019,AAA,42,16,30,58,3,3,6,0.1034482758620689,0.5,0.0517241379310344,0,-3
605446,Dereck Rodríguez,2019,AAA,17,5,6,22,0,0,0,0.0,,0.0,0,-3
605447,Jordan Romano,2019,AAA,20,13,16,33,4,0,4,0.1212121212121212,1.0,0.1212121212121212,0,-3
605452,Joe Ross,2019,AAA,31,16,8,47,4,1,5,0.1063829787234042,0.8,0.0851063829787234,0,-3
605463,Tayler Scott,2019,AAA,27,20,23,47,2,1,3,0.0638297872340425,0.6666666666666666,0.0425531914893617,0,-3
605464,Derek Self,2019,AAA,50,35,30,85,5,1,6,0.0705882352941176,0.8333333333333334,0.0588235294117647,0,-3
605469,Chandler Shepherd,2019,AAA,72,40,22,112,2,2,4,0.0357142857142857,0.5,0.0178571428571428,0,-3
605470,Grant Sides,2019,AAA,33,11,25,44,1,0,1,0.0227272727272727,1.0,0.0227272727272727,0,-3
605479,Josh D. Smith,2019,AAA,23,12,24,35,3,1,4,0.1142857142857142,0.75,0.0857142857142857,0,-3
605482,Cy Sneed,2019,AAA,44,18,17,62,3,3,6,0.0967741935483871,0.5,0.0483870967741935,0,-3
605492,Craig Stem,2019,AAA,11,8,7,19,0,0,0,0.0,,0.0,0,-3
605498,Andrew Suárez,2019,AAA,67,35,18,102,4,2,6,0.0588235294117647,0.6666666666666666,0.0392156862745098,0,-3
605501,Stephen Tarpley,2019,AAA,19,13,14,32,1,0,1,0.03125,1.0,0.03125,0,-3
605507,Zach Thompson,2019,AAA,51,25,36,76,3,1,4,0.0526315789473684,0.75,0.0394736842105263,0,-3
605525,J.B. Wendelken,2019,AAA,26,17,21,43,1,0,1,0.0232558139534883,1.0,0.0232558139534883,0,-3
605541,Mike Wright Jr.,2019,AAA,31,18,12,49,3,0,3,0.0612244897959183,1.0,0.0612244897959183,0,-3
605591,Axel Rios,2019,AAA,16,18,16,34,2,1,3,0.088235294117647,0.6666666666666666,0.0588235294117647,0,-3
606127,Jose Rafael De Paula,2019,AAA,26,12,22,38,1,1,2,0.0526315789473684,0.5,0.0263157894736842,0,-3
606131,Luis Perdomo,2019,AAA,12,2,7,14,1,2,3,0.2142857142857142,0.3333333333333333,0.0714285714285714,0,-3
606162,Yefry Ramírez,2019,AAA,40,24,17,64,10,1,11,0.171875,0.9090909090909092,0.15625,0,-3
606303,Joel Payamps,2019,AAA,23,11,8,34,1,2,3,0.088235294117647,0.3333333333333333,0.0294117647058823,0,-3
606335,Ivan Pineyro,2019,AAA,31,11,10,42,3,1,4,0.0952380952380952,0.75,0.0714285714285714,0,-3
606467,Richelson Peña,2019,AAA,20,16,7,36,0,2,2,0.0555555555555555,0.0,0.0,0,-3
606478,Pedro Araújo,2019,AAA,8,5,3,13,2,0,2,0.1538461538461538,1.0,0.1538461538461538,0,-3
606716,Luis Mateo,2019,AAA,41,20,10,61,3,2,5,0.081967213114754,0.6,0.0491803278688524,0,-3
606930,Jacob Barnes,2019,AAA,13,4,11,17,4,0,4,0.2352941176470588,1.0,0.2352941176470588,0,-3
606959,Rookie Davis,2019,AAA,41,19,13,60,7,3,10,0.1666666666666666,0.7,0.1166666666666666,0,-3
606981,Darin Gillies,2019,AAA,28,12,17,40,4,0,4,0.1,1.0,0.1,0,-3
606996,Kyle Hart,2019,AAA,63,26,18,89,0,6,6,0.0674157303370786,0.0,0.0,0,-3
607030,Adam McCreery,2019,AAA,32,10,20,42,1,0,1,0.0238095238095238,1.0,0.0238095238095238,0,-3
607067,Colin Rea,2019,AAA,96,43,26,139,24,3,27,0.1942446043165467,0.8888888888888888,0.1726618705035971,0,-3
607170,Brady Dragmire,2019,AAA,18,8,6,26,4,1,5,0.1923076923076923,0.8,0.1538461538461538,0,-3
607179,Jordan Weems,2019,AAA,18,7,7,25,3,1,4,0.16,0.75,0.12,0,-3
607188,Jake Faria,2019,AAA,33,17,20,50,0,5,5,0.1,0.0,0.0,0,-3
607200,Erick Fedde,2019,AAA,10,5,2,15,1,0,1,0.0666666666666666,1.0,0.0666666666666666,0,-3
607215,Eric Skoglund,2019,AAA,39,21,11,60,4,3,7,0.1166666666666666,0.5714285714285714,0.0666666666666666,0,-3
607216,Joey Krehbiel,2019,AAA,39,30,32,69,7,1,8,0.1159420289855072,0.875,0.1014492753623188,0,-3
607219,Sal Romano,2019,AAA,43,26,34,69,4,1,5,0.072463768115942,0.8,0.0579710144927536,0,-3
607294,Josh Martin,2019,AAA,28,19,22,47,4,1,5,0.1063829787234042,0.8,0.0851063829787234,0,-3
607316,Tyson Perez,2019,AAA,22,10,17,32,0,1,1,0.03125,0.0,0.0,0,-3
607320,Ryan Merritt,2019,AAA,55,35,26,90,7,1,8,0.0888888888888888,0.875,0.0777777777777777,0,-3
607363,Patrick Johnson,2019,AAA,84,43,24,127,4,1,5,0.0393700787401574,0.8,0.0314960629921259,0,-3
607374,Nick Tropeano,2019,AAA,56,26,17,82,8,4,12,0.1463414634146341,0.6666666666666666,0.0975609756097561,0,-3
607391,Chris Mazza,2019,AAA,39,17,14,56,1,2,3,0.0535714285714285,0.3333333333333333,0.0178571428571428,0,-3
607455,Anthony Banda,2019,AAA,20,5,9,25,2,0,2,0.08,1.0,0.08,0,-3
607536,Kyle Freeland,2019,AAA,25,16,6,41,1,0,1,0.024390243902439,1.0,0.024390243902439,0,-3
607555,Taylor Guilbeau,2019,AAA,8,10,9,18,0,1,1,0.0555555555555555,0.0,0.0,0,-3
607572,Sam Howard,2019,AAA,35,21,25,56,3,1,4,0.0714285714285714,0.75,0.0535714285714285,0,-3
607608,David Kubiak,2019,AAA,21,11,6,32,2,0,2,0.0625,1.0,0.0625,0,-3
607665,Dennis O'Grady,2019,AAA,51,26,13,77,3,5,8,0.1038961038961039,0.375,0.0389610389610389,0,-3
607673,Bennett Parry,2019,AAA,38,15,9,53,2,1,3,0.0566037735849056,0.6666666666666666,0.0377358490566037,0,-3
607692,Travis Radke,2019,AAA,24,17,17,41,1,0,1,0.024390243902439,1.0,0.024390243902439,0,-3
607729,David Sosebee,2019,AAA,32,10,22,42,4,0,4,0.0952380952380952,1.0,0.0952380952380952,0,-3
607751,Matt Tomshaw,2019,AAA,18,12,10,30,1,0,1,0.0333333333333333,1.0,0.0333333333333333,0,-3
607754,Elroy Urbina,2019,AAA,38,23,28,61,1,0,1,0.0163934426229508,1.0,0.0163934426229508,0,-3
607755,Andrew Vasquez,2019,AAA,17,11,11,28,2,0,2,0.0714285714285714,1.0,0.0714285714285714,0,-3
608167,Jonathan Aro,2019,AAA,7,8,6,15,0,0,0,0.0,,0.0,0,-3
608323,Sean Brady,2019,AAA,7,6,2,13,0,0,0,0.0,,0.0,0,-3
608328,Chase De Jong,2019,AAA,44,24,13,68,4,1,5,0.0735294117647058,0.8,0.0588235294117647,0,-3
608334,Carson Fulmer,2019,AAA,16,16,16,32,9,0,9,0.28125,1.0,0.28125,0,-3
608335,Kyle Funkhouser,2019,AAA,63,28,18,91,8,1,9,0.0989010989010989,0.8888888888888888,0.0879120879120879,0,-3
608344,Cole Irvin,2019,AAA,62,17,17,79,1,0,1,0.0126582278481012,1.0,0.0126582278481012,0,-3
608371,Lucas Sims,2019,AAA,37,34,15,71,12,5,17,0.2394366197183098,0.7058823529411765,0.1690140845070422,0,-3
608576,Gerardo Navarro,2019,AAA,32,19,17,51,0,0,0,0.0,,0.0,0,-3
608601,Luis Santos,2019,AAA,30,23,26,53,0,0,0,0.0,,0.0,0,-3
608638,JT Chargois,2019,AAA,24,16,18,40,5,0,5,0.125,1.0,0.125,0,-3
608648,Tyler Duffey,2019,AAA,5,5,5,10,2,0,2,0.2,1.0,0.2,0,-3
608650,Dietrich Enns,2019,AAA,102,53,27,155,10,2,12,0.0774193548387096,0.8333333333333334,0.064516129032258,0,-3
608678,Dominic Leone,2019,AAA,12,8,10,20,1,0,1,0.05,1.0,0.05,0,-3
608723,Austin Voth,2019,AAA,37,22,11,59,9,1,10,0.1694915254237288,0.9,0.1525423728813559,0,-3
608741,Ranfi Casimiro,2019,AAA,10,6,9,16,1,0,1,0.0625,1.0,0.0625,0,-3
608746,Cesilio Pimentel,2019,AAA,83,35,25,118,4,4,8,0.0677966101694915,0.5,0.0338983050847457,0,-3
612272,Raudel Lazo,2019,AAA,11,5,9,16,0,0,0,0.0,,0.0,0,-3
613317,Kyle Bird,2019,AAA,24,12,20,36,3,1,4,0.1111111111111111,0.75,0.0833333333333333,0,-3
613534,Austin Adams,2019,AAA,7,3,5,10,1,0,1,0.1,1.0,0.1,0,-3
613548,Pedro Fernandez,2019,AAA,24,16,11,40,0,1,1,0.025,0.0,0.0,0,-3
613575,Devin Raftery,2019,AAA,12,3,9,15,0,1,1,0.0666666666666666,0.0,0.0,0,-3
615698,Cal Quantrill,2019,AAA,23,11,7,34,1,1,2,0.0588235294117647,0.5,0.0294117647058823,0,-3
616405,Mario Meza,2019,AAA,44,24,37,68,8,1,9,0.1323529411764706,0.8888888888888888,0.1176470588235294,0,-3
616571,Rogelio Martinez,2019,AAA,35,15,20,50,4,0,4,0.08,1.0,0.08,0,-3
616572,Marco Ramirez,2019,AAA,13,7,15,20,0,0,0,0.0,,0.0,0,-3
616615,Juan Rodriguez,2019,AAA,26,13,25,39,2,1,3,0.0769230769230769,0.6666666666666666,0.0512820512820512,0,-3
616617,Adrian Gusman,2019,AAA,25,11,26,36,2,1,3,0.0833333333333333,0.6666666666666666,0.0555555555555555,0,-3
616623,Edwin Fierro,2019,AAA,28,11,22,39,0,1,1,0.0256410256410256,0.0,0.0,0,-3
617125,Yasutomo Kubo,2019,AAA,99,41,25,140,2,2,4,0.0285714285714285,0.5,0.0142857142857142,0,-3
619854,Carlos Bustamante,2019,AAA,30,14,23,44,3,1,4,0.0909090909090909,0.75,0.0681818181818181,0,-3
620982,Ricardo Pinto,2019,AAA,69,35,23,104,3,1,4,0.0384615384615384,0.75,0.0288461538461538,0,-3
621051,Steven Wilson,2019,AAA,21,5,16,26,1,0,1,0.0384615384615384,1.0,0.0384615384615384,0,-3
621052,Alex Reyes,2019,AAA,20,12,8,32,1,1,2,0.0625,0.5,0.03125,0,-3
621056,Hunter Wood,2019,AAA,10,7,7,17,0,0,0,0.0,,0.0,0,-3
621058,Andrew Moore,2019,AAA,42,31,18,73,3,0,3,0.0410958904109589,1.0,0.0410958904109589,0,-3
621068,Riley Ferrell,2019,AAA,11,5,8,16,1,0,1,0.0625,1.0,0.0625,0,-3
621078,Brady Lail,2019,AAA,5,12,9,17,0,0,0,0.0,,0.0,0,-3
621082,Jacob Lemoine,2019,AAA,19,8,12,27,3,0,3,0.1111111111111111,1.0,0.1111111111111111,0,-3
621086,James Marvel,2019,AAA,39,16,11,55,5,3,8,0.1454545454545454,0.625,0.0909090909090909,0,-3
621094,Jamie Callahan,2019,AAA,6,5,4,11,0,0,0,0.0,,0.0,0,-3
621097,Jacob Waguespack,2019,AAA,32,20,12,52,3,0,3,0.0576923076923076,1.0,0.0576923076923076,0,-3
621098,Eric Hanhold,2019,AAA,29,30,32,59,2,0,2,0.0338983050847457,1.0,0.0338983050847457,0,-3
621103,Teddy Stankiewicz,2019,AAA,67,31,24,98,4,3,7,0.0714285714285714,0.5714285714285714,0.0408163265306122,0,-3
621112,Paul Blackburn,2019,AAA,82,43,24,125,10,2,12,0.096,0.8333333333333334,0.08,0,-3
621123,Matt Custred,2019,AAA,10,7,5,17,4,2,6,0.3529411764705882,0.6666666666666666,0.2352941176470588,0,-3
621127,Andrew Sopko,2019,AAA,26,22,12,48,1,0,1,0.0208333333333333,1.0,0.0208333333333333,0,-3
621141,Walker Lockett,2019,AAA,45,27,11,72,3,0,3,0.0416666666666666,1.0,0.0416666666666666,0,-3
621143,Jackson McClelland,2019,AAA,7,4,7,11,0,0,0,0.0,,0.0,0,-3
621191,Michael Peoples,2019,AAA,78,35,25,113,2,1,3,0.0265486725663716,0.6666666666666666,0.0176991150442477,0,-3
621199,Matt Bowman,2019,AAA,21,13,18,34,3,0,3,0.088235294117647,1.0,0.088235294117647,0,-3
621200,Dillon McNamara,2019,AAA,18,8,14,26,2,1,3,0.1153846153846153,0.6666666666666666,0.0769230769230769,0,-3
621219,Alec Mills,2019,AAA,65,33,19,98,11,1,12,0.1224489795918367,0.9166666666666666,0.1122448979591836,0,-3
621248,Ralph Garza Jr.,2019,AAA,40,24,26,64,1,0,1,0.015625,1.0,0.015625,0,-3
621249,Duane Underwood Jr.,2019,AAA,62,26,27,88,7,2,9,0.1022727272727272,0.7777777777777778,0.0795454545454545,0,-3
621259,Brody Koerner,2019,AAA,72,44,20,116,7,0,7,0.0603448275862069,1.0,0.0603448275862069,0,-3
621261,Corey Oswalt,2019,AAA,40,22,16,62,0,2,2,0.032258064516129,0.0,0.0,0,-3
621289,Jaime Schultz,2019,AAA,37,21,31,58,4,2,6,0.1034482758620689,0.6666666666666666,0.0689655172413793,0,-3
621290,Dakota Bacus,2019,AAA,45,26,34,71,3,0,3,0.0422535211267605,1.0,0.0422535211267605,0,-3
621343,Matt Tenuta,2019,AAA,9,6,5,15,1,0,1,0.0666666666666666,1.0,0.0666666666666666,0,-3
621345,A.J. Minter,2019,AAA,8,5,6,13,0,0,0,0.0,,0.0,0,-3
621348,Sam Clay,2019,AAA,20,13,11,33,1,0,1,0.0303030303030303,1.0,0.0303030303030303,0,-3
621350,Caleb Frare,2019,AAA,16,10,14,26,1,1,2,0.0769230769230769,0.5,0.0384615384615384,0,-3
621363,Colin Poche,2019,AAA,18,6,12,24,2,1,3,0.125,0.6666666666666666,0.0833333333333333,0,-3
621368,Taylor Hearn,2019,AAA,9,3,4,12,0,1,1,0.0833333333333333,0.0,0.0,0,-3
621389,Ty Blach,2019,AAA,74,33,19,107,2,1,3,0.02803738317757,0.6666666666666666,0.0186915887850467,0,-3
621394,Colton Turner,2019,AAA,65,30,31,95,5,3,8,0.0842105263157894,0.625,0.0526315789473684,0,-3
621399,Brady Feigl,2019,AAA,9,4,7,13,0,0,0,0.0,,0.0,0,-3
621592,Eduardo Jiménez,2019,AAA,28,20,31,48,5,1,6,0.125,0.8333333333333334,0.1041666666666666,0,-3
622009,Jaime Lugo,2019,AAA,61,27,23,88,4,1,5,0.0568181818181818,0.8,0.0454545454545454,0,-3
622011,Yair Lozoya,2019,AAA,25,13,21,38,2,0,2,0.0526315789473684,1.0,0.0526315789473684,0,-3
622065,Alex Young,2019,AAA,43,25,18,68,3,4,7,0.1029411764705882,0.4285714285714285,0.0441176470588235,0,-3
622066,Tyler Alexander,2019,AAA,48,31,20,79,1,2,3,0.0379746835443038,0.3333333333333333,0.0126582278481012,0,-3
622075,Yency Almonte,2019,AAA,23,14,21,37,2,0,2,0.054054054054054,1.0,0.054054054054054,0,-3
622088,Tejay Antone,2019,AAA,58,24,14,82,3,4,7,0.0853658536585365,0.4285714285714285,0.0365853658536585,0,-3
622092,Kyle Zimmer,2019,AAA,32,20,28,52,5,2,7,0.1346153846153846,0.7142857142857143,0.0961538461538461,0,-3
622103,Gerardo Reyes,2019,AAA,22,12,24,34,3,1,4,0.1176470588235294,0.75,0.088235294117647,0,-3
622161,Eduardo Paredes,2019,AAA,10,8,7,18,2,0,2,0.1111111111111111,1.0,0.1111111111111111,0,-3
622218,Jordan Guerrero,2019,AAA,68,31,18,99,2,0,2,0.0202020202020202,1.0,0.0202020202020202,0,-3
622246,Bubba Derby,2019,AAA,77,31,24,108,10,2,12,0.1111111111111111,0.8333333333333334,0.0925925925925925,0,-3
622250,Josh Sborz,2019,AAA,21,27,23,48,6,1,7,0.1458333333333333,0.8571428571428571,0.125,0,-3
622251,Josh Staumont,2019,AAA,31,17,26,48,4,0,4,0.0833333333333333,1.0,0.0833333333333333,0,-3
622256,Patrick Weigel,2019,AAA,41,15,16,56,3,2,5,0.0892857142857142,0.6,0.0535714285714285,0,-3
622319,Jesus Garcia,2019,AAA,44,17,37,61,0,0,0,0.0,,0.0,0,-3
622338,Jesús Liranzo,2019,AAA,28,13,19,41,4,0,4,0.0975609756097561,1.0,0.0975609756097561,0,-3
622382,Gabriel Moya,2019,AAA,29,15,18,44,3,1,4,0.0909090909090909,0.75,0.0681818181818181,0,-3
622401,Luis Pino,2019,AAA,58,31,32,89,4,1,5,0.0561797752808988,0.8,0.0449438202247191,0,-3
622446,Jefry Rodriguez,2019,AAA,17,4,5,21,2,0,2,0.0952380952380952,1.0,0.0952380952380952,0,-3
622490,Robinson Leyer,2019,AAA,8,8,10,16,0,0,0,0.0,,0.0,0,-3
622492,Keury Mella,2019,AAA,89,56,27,145,17,3,20,0.1379310344827586,0.85,0.1172413793103448,0,-3
622503,Nabil Crismatt,2019,AAA,35,13,11,48,6,0,6,0.125,1.0,0.125,0,-3
622505,Victor Alcántara,2019,AAA,14,2,8,16,1,1,2,0.125,0.5,0.0625,0,-3
622576,Juan Martinez,2019,AAA,6,7,2,13,0,0,0,0.0,,0.0,0,-3
622608,Antonio Senzatela,2019,AAA,26,11,7,37,0,1,1,0.027027027027027,0.0,0.0,0,-3
622661,Dallas Martinez,2019,AAA,26,11,10,37,3,0,3,0.081081081081081,1.0,0.081081081081081,0,-3
622662,Rafael Ordaz,2019,AAA,24,9,16,33,0,0,0,0.0,,0.0,0,-3
622693,Harold Arauz,2019,AAA,44,18,11,62,3,2,5,0.0806451612903225,0.6,0.0483870967741935,0,-3
622694,Elieser Hernández,2019,AAA,20,9,9,29,1,0,1,0.0344827586206896,1.0,0.0344827586206896,0,-3
622703,Ronald Herrera,2019,AAA,17,12,7,29,9,0,9,0.3103448275862069,1.0,0.3103448275862069,0,-3
622742,Rafael Cordova,2019,AAA,25,15,21,40,4,1,5,0.125,0.8,0.1,0,-3
622747,Eduardo Vera,2019,AAA,88,43,23,131,19,4,23,0.1755725190839694,0.8260869565217391,0.1450381679389313,0,-3
622772,Jimmy Cordero,2019,AAA,17,16,14,33,3,0,3,0.0909090909090909,1.0,0.0909090909090909,0,-3
622774,José Manuel Fernández,2019,AAA,21,19,21,40,1,1,2,0.05,0.5,0.025,0,-3
622780,Angel Perdomo,2019,AAA,36,23,30,59,0,0,0,0.0,,0.0,0,-3
622783,Sandy Báez,2019,AAA,13,13,13,26,2,0,2,0.0769230769230769,1.0,0.0769230769230769,0,-3
622786,Jesus Tinoco,2019,AAA,29,13,21,42,0,1,1,0.0238095238095238,0.0,0.0,0,-3
622797,Pedro Payano,2019,AAA,27,12,10,39,1,0,1,0.0256410256410256,1.0,0.0256410256410256,0,-3
622864,Fernando Romero,2019,AAA,50,29,28,79,1,1,2,0.0253164556962025,0.5,0.0126582278481012,0,-3
623149,Paul Sewald,2019,AAA,39,16,29,55,3,2,5,0.0909090909090909,0.6,0.0545454545454545,0,-3
623167,Chris Flexen,2019,AAA,46,30,23,76,0,1,1,0.0131578947368421,0.0,0.0,0,-3
623183,Zach Lovvorn,2019,AAA,76,40,21,116,3,1,4,0.0344827586206896,0.75,0.0258620689655172,0,-3
623354,Daniel Zamora,2019,AAA,17,8,14,25,1,0,1,0.04,1.0,0.04,0,-3
623364,Brad Wieck,2019,AAA,10,5,10,15,0,0,0,0.0,,0.0,0,-3
623381,Thomas Pannone,2019,AAA,14,10,7,24,0,0,0,0.0,,0.0,0,-3
623395,Brian Ellington,2019,AAA,10,6,8,16,1,0,1,0.0625,1.0,0.0625,0,-3
623402,Tim Peterson,2019,AAA,24,11,24,35,2,1,3,0.0857142857142857,0.6666666666666666,0.0571428571428571,0,-3
623430,Ryan Dull,2019,AAA,18,21,22,39,0,0,0,0.0,,0.0,0,-3
623434,Mike Hauschild,2019,AAA,26,18,9,44,1,0,1,0.0227272727272727,1.0,0.0227272727272727,0,-3
623439,Ryan Garton,2019,AAA,38,17,29,55,3,1,4,0.0727272727272727,0.75,0.0545454545454545,0,-3
623451,Jackson Stephens,2019,AAA,68,31,36,99,17,2,19,0.1919191919191919,0.8947368421052632,0.1717171717171717,0,-3
623454,Drew Anderson,2019,AAA,33,19,11,52,10,2,12,0.2307692307692307,0.8333333333333334,0.1923076923076923,0,-3
623465,Evan Phillips,2019,AAA,27,12,18,39,1,1,2,0.0512820512820512,0.5,0.0256410256410256,0,-3
623470,Jake Newberry,2019,AAA,26,13,17,39,1,0,1,0.0256410256410256,1.0,0.0256410256410256,0,-3
623474,Jimmy Herget,2019,AAA,25,19,28,44,7,0,7,0.1590909090909091,1.0,0.1590909090909091,0,-3
623490,Brad Markey,2019,AAA,21,17,10,38,2,1,3,0.0789473684210526,0.6666666666666666,0.0526315789473684,0,-3
623491,Benny Suarez,2019,AAA,25,14,25,39,4,0,4,0.1025641025641025,1.0,0.1025641025641025,0,-3
623913,Wei-Chung Wang,2019,AAA,19,8,13,27,1,0,1,0.037037037037037,1.0,0.037037037037037,0,-3
623985,Manuel Chavez,2019,AAA,24,7,24,31,1,2,3,0.0967741935483871,0.3333333333333333,0.032258064516129,0,-3
623992,Shao-Ching Chiang,2019,AAA,79,48,25,127,3,1,4,0.0314960629921259,0.75,0.0236220472440944,0,-3
624133,Ranger Suárez,2019,AAA,22,9,7,31,1,2,3,0.0967741935483871,0.3333333333333333,0.032258064516129,0,-3
624418,Ryan Castellani,2019,AAA,37,21,10,58,5,1,6,0.1034482758620689,0.8333333333333334,0.0862068965517241,0,-3
624586,James Hoyt,2019,AAA,35,16,28,51,8,3,11,0.2156862745098039,0.7272727272727273,0.1568627450980392,0,-3
624646,Lenix Osuna,2019,AAA,15,7,10,22,1,0,1,0.0454545454545454,1.0,0.0454545454545454,0,-3
624647,Victor González,2019,AAA,12,3,9,15,0,0,0,0.0,,0.0,0,-3
626929,Lewis Thorpe,2019,AAA,46,22,18,68,1,1,2,0.0294117647058823,0.5,0.0147058823529411,0,-3
626997,Nicolas Heredia,2019,AAA,34,24,29,58,3,0,3,0.0517241379310344,1.0,0.0517241379310344,0,-3
628240,Josh Lowey,2019,AAA,26,10,8,36,1,1,2,0.0555555555555555,0.5,0.0277777777777777,0,-3
628318,Kazuhisa Makita,2019,AAA,7,6,6,13,1,0,1,0.0769230769230769,1.0,0.0769230769230769,0,-3
628333,Odrisamer Despaigne,2019,AAA,77,27,23,104,3,3,6,0.0576923076923076,0.5,0.0288461538461538,0,-3
628708,Yunior Marte,2019,AAA,21,16,17,37,1,0,1,0.027027027027027,1.0,0.027027027027027,0,-3
628709,Ofreidy Gómez,2019,AAA,14,10,6,24,1,1,2,0.0833333333333333,0.5,0.0416666666666666,0,-3
629496,Chih-Wei Hu,2019,AAA,35,20,15,55,7,2,9,0.1636363636363636,0.7777777777777778,0.1272727272727272,0,-3
630241,Trent Szkutnik,2019,AAA,17,6,12,23,2,0,2,0.0869565217391304,1.0,0.0869565217391304,0,-3
630263,James Bourque,2019,AAA,37,16,23,53,6,0,6,0.1132075471698113,1.0,0.1132075471698113,0,-3
631229,Dalton Rodriguez,2019,AAA,20,10,18,30,1,1,2,0.0666666666666666,0.5,0.0333333333333333,0,-3
634323,Jorge Quinones,2019,AAA,11,8,9,19,0,1,1,0.0526315789473684,0.0,0.0,0,-3
634325,Gabino Avalos,2019,AAA,14,22,12,36,5,0,5,0.1388888888888889,1.0,0.1388888888888889,0,-3
635903,Chris Rowley,2019,AAA,11,9,5,20,1,0,1,0.05,1.0,0.05,0,-3
636030,Abel Amaya,2019,AAA,11,7,5,18,0,0,0,0.0,,0.0,0,-3
639373,Gerson Bautista,2019,AAA,16,8,14,24,2,0,2,0.0833333333333333,1.0,0.0833333333333333,0,-3
640444,Wil Crowe,2019,AAA,41,23,10,64,1,1,2,0.03125,0.5,0.015625,0,-3
640448,Kyle Finnegan,2019,AAA,19,9,14,28,0,2,2,0.0714285714285714,0.0,0.0,0,-3
640451,Hunter Harvey,2019,AAA,8,7,5,15,0,0,0,0.0,,0.0,0,-3
640455,Sean Manaea,2019,AAA,9,5,5,14,1,0,1,0.0714285714285714,1.0,0.0714285714285714,0,-3
640463,Braden Shipley,2019,AAA,60,31,25,91,3,1,4,0.0439560439560439,0.75,0.0329670329670329,0,-3
640464,Kohl Stewart,2019,AAA,57,43,20,100,10,1,11,0.11,0.9090909090909092,0.1,0,-3
640470,Adbert Alzolay,2019,AAA,33,17,14,50,8,2,10,0.2,0.8,0.16,0,-3
640485,Alexis Rivero,2019,AAA,18,7,11,25,1,0,1,0.04,1.0,0.04,0,-3
641149,Wes Parsons,2019,AAA,54,20,26,74,1,2,3,0.0405405405405405,0.3333333333333333,0.0135135135135135,0,-3
641154,Pablo López,2019,AAA,10,3,2,13,2,0,2,0.1538461538461538,1.0,0.1538461538461538,0,-3
641241,Hector Galvan,2019,AAA,91,42,22,133,18,4,22,0.1654135338345864,0.8181818181818182,0.1353383458646616,0,-3
641302,Tyler Alexander,2019,AAA,45,28,20,73,4,0,4,0.0547945205479452,1.0,0.0547945205479452,0,-3
641312,Shaun Anderson,2019,AAA,21,11,8,32,0,0,0,0.0,,0.0,0,-3
641329,Bryan Baker,2019,AAA,8,6,11,14,0,0,0,0.0,,0.0,0,-3
641334,Matt Ball,2019,AAA,31,10,13,41,4,0,4,0.0975609756097561,1.0,0.0975609756097561,0,-3
641341,Tyler Bashlor,2019,AAA,19,13,18,32,1,2,3,0.09375,0.3333333333333333,0.03125,0,-3
641384,Akeem Bostick,2019,AAA,60,31,20,91,6,0,6,0.0659340659340659,1.0,0.0659340659340659,0,-3
641386,Ben Bowden,2019,AAA,18,9,15,27,0,0,0,0.0,,0.0,0,-3
641394,Jake Brentz,2019,AAA,31,11,16,42,3,1,4,0.0952380952380952,0.75,0.0714285714285714,0,-3
641401,Connor Brogdon,2019,AAA,11,8,13,19,2,0,2,0.1052631578947368,1.0,0.1052631578947368,0,-3
641409,Zack Brown,2019,AAA,100,48,25,148,6,0,6,0.0405405405405405,1.0,0.0405405405405405,0,-3
641425,Thomas Burrows,2019,AAA,25,14,18,39,1,0,1,0.0256410256410256,1.0,0.0256410256410256,0,-3
641438,Shane Carle,2019,AAA,34,23,22,57,5,0,5,0.087719298245614,1.0,0.087719298245614,0,-3
641455,Andrew Church,2019,AAA,6,4,1,10,0,0,0,0.0,,0.0,0,-3
641461,Trevor Clifton,2019,AAA,59,42,23,101,22,1,23,0.2277227722772277,0.9565217391304348,0.2178217821782178,0,-3
641462,Corbin Clouse,2019,AAA,19,9,11,28,1,0,1,0.0357142857142857,1.0,0.0357142857142857,0,-3
641482,Nestor Cortes,2019,AAA,15,7,6,22,3,1,4,0.1818181818181818,0.75,0.1363636363636363,0,-3
641483,Cale Coshow,2019,AAA,10,8,9,18,3,1,4,0.2222222222222222,0.75,0.1666666666666666,0,-3
641501,Tyler Danish,2019,AAA,24,10,6,34,0,1,1,0.0294117647058823,0.0,0.0,0,-3
641506,Adrian De Horta,2019,AAA,21,8,11,29,2,1,3,0.1034482758620689,0.6666666666666666,0.0689655172413793,0,-3
641541,Jon Duplantier,2019,AAA,26,16,12,42,3,2,5,0.119047619047619,0.6,0.0714285714285714,0,-3
641571,Heath Fillmyer,2019,AAA,31,22,14,53,6,1,7,0.1320754716981132,0.8571428571428571,0.1132075471698113,0,-3
641582,Matt Foster,2019,AAA,31,15,21,46,2,0,2,0.0434782608695652,1.0,0.0434782608695652,0,-3
641632,Conner Greene,2019,AAA,11,8,8,19,3,0,3,0.1578947368421052,1.0,0.1578947368421052,0,-3
641646,Joe Gunkel,2019,AAA,47,19,17,66,0,2,2,0.0303030303030303,0.0,0.0,0,-3
641656,Ian Hamilton,2019,AAA,13,5,8,18,1,0,1,0.0555555555555555,1.0,0.0555555555555555,0,-3
641663,Conor Harber,2019,AAA,36,15,9,51,1,1,2,0.0392156862745098,0.5,0.0196078431372549,0,-3
641665,Jose Haros,2019,AAA,15,7,9,22,1,0,1,0.0454545454545454,1.0,0.0454545454545454,0,-3
641709,Brian Howard,2019,AAA,12,8,4,20,4,0,4,0.2,1.0,0.2,0,-3
641733,Connor Johnstone,2019,AAA,7,7,5,14,0,1,1,0.0714285714285714,0.0,0.0,0,-3
641739,Rob Kaminsky,2019,AAA,16,9,12,25,0,1,1,0.04,0.0,0.0,0,-3
641743,Anthony Kay,2019,AAA,43,21,14,64,3,2,5,0.078125,0.6,0.046875,0,-3
641754,Jeff Kinley,2019,AAA,13,7,7,20,1,0,1,0.05,1.0,0.05,0,-3
641755,Tyler Kinley,2019,AAA,11,2,6,13,0,0,0,0.0,,0.0,0,-3
641793,Zack Littell,2019,AAA,34,19,15,53,5,1,6,0.1132075471698113,0.8333333333333334,0.0943396226415094,0,-3
641806,Ryan Luna,2019,AAA,37,23,30,60,5,1,6,0.1,0.8333333333333334,0.0833333333333333,0,-3
641838,Kevin McCarthy,2019,AAA,13,10,8,23,2,0,2,0.0869565217391304,1.0,0.0869565217391304,0,-3
641850,Kevin McGowan,2019,AAA,22,11,5,33,8,1,9,0.2727272727272727,0.8888888888888888,0.2424242424242424,0,-3
641851,Kyle McGowin,2019,AAA,25,16,11,41,2,0,2,0.048780487804878,1.0,0.048780487804878,0,-3
641853,David McKay,2019,AAA,31,13,23,44,5,0,5,0.1136363636363636,1.0,0.1136363636363636,0,-3
641861,Casey Meisner,2019,AAA,11,4,4,15,0,0,0,0.0,,0.0,0,-3
641872,Jordan Milbrath,2019,AAA,34,18,21,52,7,1,8,0.1538461538461538,0.875,0.1346153846153846,0,-3
641887,Evan Mitchell,2019,AAA,17,11,3,28,2,2,4,0.1428571428571428,0.5,0.0714285714285714,0,-3
641900,Scott Moss,2019,AAA,8,3,4,11,3,0,3,0.2727272727272727,1.0,0.2727272727272727,0,-3
641959,Jake Paulson,2019,AAA,10,1,2,11,0,0,0,0.0,,0.0,0,-3
641962,CD Pelham,2019,AAA,10,9,8,19,3,0,3,0.1578947368421052,1.0,0.1578947368421052,0,-3
641980,Matt Pierpont,2019,AAA,22,7,18,29,4,0,4,0.1379310344827586,1.0,0.1379310344827586,0,-3
641988,Alex Powers,2019,AAA,16,10,16,26,3,0,3,0.1153846153846153,1.0,0.1153846153846153,0,-3
642003,Cody Reed,2019,AAA,7,6,10,13,3,0,3,0.2307692307692307,1.0,0.2307692307692307,0,-3
642007,Arturo Reyes,2019,AAA,68,46,23,114,5,0,5,0.043859649122807,1.0,0.043859649122807,0,-3
642008,Jacob Rhame,2019,AAA,8,5,8,13,2,0,2,0.1538461538461538,1.0,0.1538461538461538,0,-3
642028,Josh Rogers,2019,AAA,39,19,11,58,2,0,2,0.0344827586206896,1.0,0.0344827586206896,0,-3
642041,Zac Ryan,2019,AAA,26,14,18,40,5,0,5,0.125,1.0,0.125,0,-3
642048,Tayler Saucedo,2019,AAA,54,25,22,79,5,0,5,0.0632911392405063,1.0,0.0632911392405063,0,-3
642067,Mike Shawaryn,2019,AAA,63,23,23,86,7,1,8,0.0930232558139534,0.875,0.0813953488372093,0,-3
642073,Jimmie Sherfy,2019,AAA,26,13,21,39,4,0,4,0.1025641025641025,1.0,0.1025641025641025,0,-3
642083,Aaron Slegers,2019,AAA,62,45,26,107,11,3,14,0.1308411214953271,0.7857142857142857,0.102803738317757,0,-3
642092,Riley Smith,2019,AAA,43,24,12,67,4,4,8,0.1194029850746268,0.5,0.0597014925373134,0,-3
642100,Gabe Speier,2019,AAA,21,13,18,34,2,2,4,0.1176470588235294,0.5,0.0588235294117647,0,-3
642119,Cody Stull,2019,AAA,7,3,5,10,1,0,1,0.1,1.0,0.1,0,-3
642121,Cole Sulser,2019,AAA,25,16,24,41,2,1,3,0.073170731707317,0.6666666666666666,0.048780487804878,0,-3
642203,Taylor Widener,2019,AAA,52,47,21,99,13,2,15,0.1515151515151515,0.8666666666666667,0.1313131313131313,0,-3
642226,Matt Wotherspoon,2019,AAA,43,24,26,67,4,1,5,0.0746268656716417,0.8,0.0597014925373134,0,-3
642231,Jimmy Yacabonis,2019,AAA,16,13,14,29,2,0,2,0.0689655172413793,1.0,0.0689655172413793,0,-3
642232,Ryan Yarbrough,2019,AAA,11,6,5,17,1,0,1,0.0588235294117647,1.0,0.0588235294117647,0,-3
642233,Eric Yardley,2019,AAA,36,22,27,58,3,2,5,0.0862068965517241,0.6,0.0517241379310344,0,-3
642239,Rob Zastryzny,2019,AAA,65,38,20,103,3,3,6,0.058252427184466,0.5,0.029126213592233,0,-3
642375,Jose Carlos Medina,2019,AAA,67,36,27,103,1,2,3,0.029126213592233,0.3333333333333333,0.0097087378640776,0,-3
642381,Dedgar Jimenez,2019,AAA,8,3,2,11,1,0,1,0.0909090909090909,1.0,0.0909090909090909,0,-3
642397,Gregory Soto,2019,AAA,18,7,6,25,5,2,7,0.28,0.7142857142857143,0.2,0,-3
642511,Arnaldo Hernandez,2019,AAA,80,46,22,126,9,3,12,0.0952380952380952,0.75,0.0714285714285714,0,-3
642545,Jaime Barria,2019,AAA,25,19,10,44,1,0,1,0.0227272727272727,1.0,0.0227272727272727,0,-3
642558,Ariel Jurado,2019,AAA,14,9,4,23,2,1,3,0.1304347826086956,0.6666666666666666,0.0869565217391304,0,-3
642578,José Rodríguez,2019,AAA,39,18,17,57,1,0,1,0.0175438596491228,1.0,0.0175438596491228,0,-3
642590,Francisco Rios,2019,AAA,20,12,13,32,1,0,1,0.03125,1.0,0.03125,0,-3
642607,Dario Agrazal,2019,AAA,31,18,12,49,0,1,1,0.0204081632653061,0.0,0.0,0,-3
642609,Joan Baez,2019,AAA,18,16,14,34,2,2,4,0.1176470588235294,0.5,0.0588235294117647,0,-3
642629,Emmanuel Ramirez,2019,AAA,31,22,10,53,6,1,7,0.1320754716981132,0.8571428571428571,0.1132075471698113,0,-3
642659,Raynel Espinal,2019,AAA,36,23,18,59,7,3,10,0.1694915254237288,0.7,0.1186440677966101,0,-3
642701,Dennis Santana,2019,AAA,72,41,22,113,11,2,13,0.1150442477876106,0.8461538461538461,0.0973451327433628,0,-3
642758,Domingo Acevedo,2019,AAA,9,5,9,14,1,0,1,0.0714285714285714,1.0,0.0714285714285714,0,-3
642840,Joe Harvey,2019,AAA,17,13,17,30,2,0,2,0.0666666666666666,1.0,0.0666666666666666,0,-3
642856,Fabian Anguamea,2019,AAA,41,20,25,61,0,2,2,0.0327868852459016,0.0,0.0,0,-3
643239,Parker Bugg,2019,AAA,19,11,15,30,5,1,6,0.2,0.8333333333333334,0.1666666666666666,0,-3
643354,Donnie Hart,2019,AAA,32,17,28,49,5,0,5,0.1020408163265306,1.0,0.1020408163265306,0,-3
643377,Griffin Jax,2019,AAA,10,6,3,16,3,0,3,0.1875,1.0,0.1875,0,-3
643400,Dusten Knight,2019,AAA,13,8,13,21,1,1,2,0.0952380952380952,0.5,0.0476190476190476,0,-3
643458,Jordan Mills,2019,AAA,15,14,12,29,0,0,0,0.0,,0.0,0,-3
643466,Harrison Musgrave,2019,AAA,22,22,15,44,4,0,4,0.0909090909090909,1.0,0.0909090909090909,0,-3
643493,Austin Pruitt,2019,AAA,33,15,15,48,1,0,1,0.0208333333333333,1.0,0.0208333333333333,0,-3
643511,Tyler Rogers,2019,AAA,44,27,34,71,3,0,3,0.0422535211267605,1.0,0.0422535211267605,0,-3
643518,Jose Samayoa,2019,AAA,74,32,22,106,2,3,5,0.0471698113207547,0.4,0.0188679245283018,0,-3
643550,Layne Somsen,2019,AAA,8,2,5,10,2,0,2,0.2,1.0,0.2,0,-3
643566,Rick Teasley,2019,AAA,15,7,4,22,0,0,0,0.0,,0.0,0,-3
643588,Tyler Viza,2019,AAA,62,28,18,90,3,1,4,0.0444444444444444,0.75,0.0333333333333333,0,-3
643605,Matt Whitehouse,2019,AAA,13,5,9,18,0,0,0,0.0,,0.0,0,-3
643615,T.J. Zeuch,2019,AAA,51,24,12,75,5,1,6,0.08,0.8333333333333334,0.0666666666666666,0,-3
643617,Zac Reininger,2019,AAA,41,23,26,64,1,1,2,0.03125,0.5,0.015625,0,-3
644391,Scott Harkin,2019,AAA,53,25,17,78,8,3,11,0.141025641025641,0.7272727272727273,0.1025641025641025,0,-3
644425,Jake Sanchez,2019,AAA,20,11,16,31,4,0,4,0.1290322580645161,1.0,0.1290322580645161,0,-3
644443,Luis Ysla,2019,AAA,76,40,21,116,13,2,15,0.1293103448275862,0.8666666666666667,0.1120689655172413,0,-3
644577,Carlos Felix,2019,AAA,67,24,26,91,6,1,7,0.0769230769230769,0.8571428571428571,0.0659340659340659,0,-3
645179,Luis Ivan Rodriguez,2019,AAA,37,18,31,55,2,5,7,0.1272727272727272,0.2857142857142857,0.0363636363636363,0,-3
645417,Edgar Gomez,2019,AAA,73,41,33,114,2,2,4,0.0350877192982456,0.5,0.0175438596491228,0,-3
645799,Isaac Jimenez,2019,AAA,52,20,38,72,3,2,5,0.0694444444444444,0.6,0.0416666666666666,0,-3
648097,Marco Antonio Rivas,2019,AAA,43,17,30,60,1,1,2,0.0333333333333333,0.5,0.0166666666666666,0,-3
649228,Jorge Martinez,2019,AAA,72,38,23,110,11,4,15,0.1363636363636363,0.7333333333333333,0.1,0,-3
650204,Norge Ruiz,2019,AAA,30,21,15,51,1,0,1,0.0196078431372549,1.0,0.0196078431372549,0,-3
650382,Darwinzon Hernández,2019,AAA,14,7,4,21,4,0,4,0.1904761904761904,1.0,0.1904761904761904,0,-3
650493,Henry Martinez,2019,AAA,28,20,24,48,2,0,2,0.0416666666666666,1.0,0.0416666666666666,0,-3
650530,Bryan Garcia,2019,AAA,15,9,16,24,2,0,2,0.0833333333333333,1.0,0.0833333333333333,0,-3
650574,Mike Franco,2019,AAA,13,13,13,26,1,3,4,0.1538461538461538,0.25,0.0384615384615384,0,-3
650633,Michael King,2019,AAA,13,7,4,20,1,0,1,0.05,1.0,0.05,0,-3
650644,Aaron Civale,2019,AAA,19,10,6,29,1,0,1,0.0344827586206896,1.0,0.0344827586206896,0,-3
650656,Luis Pena,2019,AAA,16,8,6,24,0,0,0,0.0,,0.0,0,-3
650671,José Quijada,2019,AAA,20,5,14,25,0,1,1,0.04,0.0,0.0,0,-3
650738,Adonis Rosa,2019,AAA,27,14,12,41,0,1,1,0.024390243902439,0.0,0.0,0,-3
650810,José Taveras,2019,AAA,28,12,9,40,3,0,3,0.075,1.0,0.075,0,-3
650813,Luis Escobar,2019,AAA,46,18,24,64,5,2,7,0.109375,0.7142857142857143,0.078125,0,-3
650830,Eumir Sepulveda,2019,AAA,31,11,13,42,2,1,3,0.0714285714285714,0.6666666666666666,0.0476190476190476,0,-3
650893,Génesis Cabrera,2019,AAA,52,32,20,84,6,1,7,0.0833333333333333,0.8571428571428571,0.0714285714285714,0,-3
650980,Samuel Zazueta,2019,AAA,10,4,4,14,0,0,0,0.0,,0.0,0,-3
653203,Ruben Molina,2019,AAA,13,15,24,28,2,2,4,0.1428571428571428,0.5,0.0714285714285714,0,-3
653252,Sasagi Sanchez,2019,AAA,39,19,36,58,4,0,4,0.0689655172413793,1.0,0.0689655172413793,0,-3
653540,Francisco Moreno,2019,AAA,42,28,29,70,2,0,2,0.0285714285714285,1.0,0.0285714285714285,0,-3
653857,Jorge Rivera,2019,AAA,7,4,3,11,2,0,2,0.1818181818181818,1.0,0.1818181818181818,0,-3
654034,Wilfredo Ramirez,2019,AAA,17,8,12,25,1,1,2,0.08,0.5,0.04,0,-3
656083,Harol González,2019,AAA,22,5,8,27,0,0,0,0.0,,0.0,0,-3
656181,Spencer Adams,2019,AAA,24,7,5,31,5,1,6,0.1935483870967742,0.8333333333333334,0.1612903225806451,0,-3
656186,Dan Altavilla,2019,AAA,11,5,10,16,2,0,2,0.125,1.0,0.125,0,-3
656196,Argenis Angulo,2019,AAA,12,9,14,21,1,1,2,0.0952380952380952,0.5,0.0476190476190476,0,-3
656212,Charlie Barnes,2019,AAA,17,7,4,24,2,0,2,0.0833333333333333,1.0,0.0833333333333333,0,-3
656232,Brandon Bielak,2019,AAA,43,22,15,65,5,3,8,0.123076923076923,0.625,0.0769230769230769,0,-3
656240,Scott Blewett,2019,AAA,67,34,18,101,8,3,11,0.1089108910891089,0.7272727272727273,0.0792079207920792,0,-3
656257,Jeff Brigham,2019,AAA,10,5,10,15,4,1,5,0.3333333333333333,0.8,0.2666666666666666,0,-3
656271,Brock Burke,2019,AAA,8,3,2,11,0,0,0,0.0,,0.0,0,-3
656302,Dylan Cease,2019,AAA,55,29,15,84,7,1,8,0.0952380952380952,0.875,0.0833333333333333,0,-3
656322,Sam Coonrod,2019,AAA,23,14,18,37,1,1,2,0.054054054054054,0.5,0.027027027027027,0,-3
656345,Andro Cutura,2019,AAA,6,6,1,12,0,0,0,0.0,,0.0,0,-3
656353,Tucker Davidson,2019,AAA,20,4,4,24,1,1,2,0.0833333333333333,0.5,0.0416666666666666,0,-3
656354,Austin Davis,2019,AAA,23,17,21,40,3,1,4,0.1,0.75,0.075,0,-3
656420,J.P. Feyereisen,2019,AAA,19,32,26,51,5,2,7,0.1372549019607843,0.7142857142857143,0.0980392156862745,0,-3
656457,Tyler Gilbert,2019,AAA,28,11,28,39,0,0,0,0.0,,0.0,0,-3
656464,Kevin Ginkel,2019,AAA,9,3,9,12,0,0,0,0.0,,0.0,0,-3
656492,Foster Griffin,2019,AAA,112,50,25,162,11,4,15,0.0925925925925925,0.7333333333333333,0.0679012345679012,0,-3
656546,Jeff Hoffman,2019,AAA,60,32,16,92,10,3,13,0.1413043478260869,0.7692307692307693,0.108695652173913,0,-3
656547,Jonathan Holder,2019,AAA,10,1,6,11,1,0,1,0.0909090909090909,1.0,0.0909090909090909,0,-3
656557,Tanner Houck,2019,AAA,12,16,11,28,3,0,3,0.1071428571428571,1.0,0.1071428571428571,0,-3
656605,Mitch Keller,2019,AAA,60,24,19,84,7,3,10,0.119047619047619,0.7,0.0833333333333333,0,-3
656613,Sean Keselica,2019,AAA,35,22,24,57,0,2,2,0.0350877192982456,0.0,0.0,0,-3
656657,Zach Logue,2019,AAA,6,8,1,14,2,0,2,0.1428571428571428,1.0,0.1428571428571428,0,-3
656661,José López,2019,AAA,33,19,9,52,0,0,0,0.0,,0.0,0,-3
656671,Josh Maciejewski,2019,AAA,6,5,3,11,1,1,2,0.1818181818181818,0.5,0.0909090909090909,0,-3
656674,Kolton Mahoney,2019,AAA,18,4,4,22,0,1,1,0.0454545454545454,0.0,0.0,0,-3
656686,Corbin Martin,2019,AAA,32,12,9,44,3,1,4,0.0909090909090909,0.75,0.0681818181818181,0,-3
656713,Brendan McKay,2019,AAA,12,5,7,17,1,0,1,0.0588235294117647,1.0,0.0588235294117647,0,-3
656725,Alex McRae,2019,AAA,83,38,22,121,10,5,15,0.1239669421487603,0.6666666666666666,0.0826446280991735,0,-3
656726,Sam McWilliams,2019,AAA,42,25,10,67,5,1,6,0.0895522388059701,0.8333333333333334,0.0746268656716417,0,-3
656730,Trevor Megill,2019,AAA,34,22,25,56,3,2,5,0.0892857142857142,0.6,0.0535714285714285,0,-3
656738,Ben Meyer,2019,AAA,57,24,17,81,2,2,4,0.0493827160493827,0.5,0.0246913580246913,0,-3
656793,Nick Nelson,2019,AAA,7,6,4,13,1,1,2,0.1538461538461538,0.5,0.0769230769230769,0,-3
656794,Sean Newcomb,2019,AAA,10,5,4,15,0,0,0,0.0,,0.0,0,-3
656803,James Norwood,2019,AAA,22,23,28,45,3,2,5,0.1111111111111111,0.6,0.0666666666666666,0,-3
656814,Luis F. Ortiz,2019,AAA,52,21,14,73,7,0,7,0.0958904109589041,1.0,0.0958904109589041,0,-3
656839,Jorge Perez,2019,AAA,46,15,25,61,1,0,1,0.0163934426229508,1.0,0.0163934426229508,0,-3
656887,Sean Reid-Foley,2019,AAA,60,30,19,90,11,3,14,0.1555555555555555,0.7857142857142857,0.1222222222222222,0,-3
656889,Jeremy Rhoades,2019,AAA,32,27,26,59,8,0,8,0.135593220338983,1.0,0.135593220338983,0,-3
656904,Jared Robinson,2019,AAA,19,5,9,24,0,0,0,0.0,,0.0,0,-3
656945,Tanner Scott,2019,AAA,26,17,20,43,0,0,0,0.0,,0.0,0,-3
656954,Justus Sheffield,2019,AAA,36,19,13,55,1,2,3,0.0545454545454545,0.3333333333333333,0.0181818181818181,0,-3
656970,Devin Smeltzer,2019,AAA,37,18,14,55,4,1,5,0.0909090909090909,0.8,0.0727272727272727,0,-3
656977,Chad Sobotka,2019,AAA,10,3,8,13,0,0,0,0.0,,0.0,0,-3
657017,Cole Sturgeon,2019,AAA,6,5,3,11,0,0,0,0.0,,0.0,0,-3
657022,Trey Supak,2019,AAA,14,10,7,24,1,0,1,0.0416666666666666,1.0,0.0416666666666666,0,-3
657024,Erik Swanson,2019,AAA,15,9,9,24,3,1,4,0.1666666666666666,0.75,0.125,0,-3
657031,Josh Taylor,2019,AAA,12,10,9,22,4,1,5,0.2272727272727272,0.8,0.1818181818181818,0,-3
657053,Touki Toussaint,2019,AAA,32,17,10,49,1,1,2,0.0408163265306122,0.5,0.0204081632653061,0,-3
657081,Paul Voelker,2019,AAA,37,21,26,58,4,2,6,0.1034482758620689,0.6666666666666666,0.0689655172413793,0,-3
657093,Spenser Watkins,2019,AAA,50,31,16,81,12,1,13,0.1604938271604938,0.9230769230769232,0.1481481481481481,0,-3
657097,Jacob Webb,2019,AAA,8,6,6,14,0,0,0,0.0,,0.0,0,-3
657140,Kyle Wright,2019,AAA,69,36,21,105,9,2,11,0.1047619047619047,0.8181818181818182,0.0857142857142857,0,-3
657203,Will Carter,2019,AAA,18,8,10,26,1,0,1,0.0384615384615384,1.0,0.0384615384615384,0,-3
657205,Zac Curtis,2019,AAA,18,20,16,38,3,0,3,0.0789473684210526,1.0,0.0789473684210526,0,-3
657209,Dean Deetz,2019,AAA,32,12,18,44,1,0,1,0.0227272727272727,1.0,0.0227272727272727,0,-3
657228,Jake Jewell,2019,AAA,24,21,22,45,1,0,1,0.0222222222222222,1.0,0.0222222222222222,0,-3
657424,Matt Gage,2019,AAA,69,41,24,110,5,4,9,0.0818181818181818,0.5555555555555556,0.0454545454545454,0,-3
657511,Dustin Beggs,2019,AAA,54,27,13,81,9,3,12,0.1481481481481481,0.75,0.1111111111111111,0,-3
657514,Brennan Bernardino,2019,AAA,20,4,17,24,1,1,2,0.0833333333333333,0.5,0.0416666666666666,0,-3
657518,Matt Blackham,2019,AAA,13,4,8,17,1,0,1,0.0588235294117647,1.0,0.0588235294117647,0,-3
657530,Joe Broussard,2019,AAA,20,14,14,34,4,1,5,0.1470588235294117,0.8,0.1176470588235294,0,-3
657566,Montana DuRapau,2019,AAA,9,7,12,16,1,0,1,0.0625,1.0,0.0625,0,-3
657583,Luis Gamez,2019,AAA,39,24,23,63,4,0,4,0.0634920634920634,1.0,0.0634920634920634,0,-3
657585,Reed Garrett,2019,AAA,29,23,23,52,5,0,5,0.0961538461538461,1.0,0.0961538461538461,0,-3
657610,Trevor Hildenberger,2019,AAA,16,6,9,22,1,1,2,0.0909090909090909,0.5,0.0454545454545454,0,-3
657611,Cam Hill,2019,AAA,15,7,13,22,1,1,2,0.0909090909090909,0.5,0.0454545454545454,0,-3
657612,Tim Hill,2019,AAA,19,6,15,25,2,0,2,0.08,1.0,0.08,0,-3
657644,Alex Klonowski,2019,AAA,55,28,16,83,4,2,6,0.072289156626506,0.6666666666666666,0.0481927710843373,0,-3
657664,Lucas Long,2019,AAA,9,5,6,14,0,0,0,0.0,,0.0,0,-3
657670,Greg Mahle,2019,AAA,29,23,12,52,0,1,1,0.0192307692307692,0.0,0.0,0,-3
657680,Brendan McCurry,2019,AAA,37,21,26,58,7,0,7,0.1206896551724138,1.0,0.1206896551724138,0,-3
657681,Kyle McGrath,2019,AAA,36,29,20,65,5,1,6,0.0923076923076923,0.8333333333333334,0.0769230769230769,0,-3
657697,Vinny Nittoli,2019,AAA,13,10,5,23,2,1,3,0.1304347826086956,0.6666666666666666,0.0869565217391304,0,-3
657714,Jon Perrin,2019,AAA,9,9,3,18,0,0,0,0.0,,0.0,0,-3
657766,Locke St. John,2019,AAA,12,6,10,18,0,0,0,0.0,,0.0,0,-3
657770,Eric Stout,2019,AAA,43,19,18,62,4,0,4,0.064516129032258,1.0,0.064516129032258,0,-3
657793,Connor Walsh,2019,AAA,33,21,22,54,1,1,2,0.037037037037037,0.5,0.0185185185185185,0,-3
658140,Wilmer Rios,2019,AAA,52,22,20,74,8,3,11,0.1486486486486486,0.7272727272727273,0.1081081081081081,0,-3
658305,Edgar García,2019,AAA,13,3,11,16,2,0,2,0.125,1.0,0.125,0,-3
658551,Junior Fernández,2019,AAA,18,6,12,24,1,1,2,0.0833333333333333,0.5,0.0416666666666666,0,-3
658791,Wei-Chieh Huang,2019,AAA,22,15,15,37,8,3,11,0.2972972972972973,0.7272727272727273,0.2162162162162162,0,-3
658792,Aaron Wilkerson,2019,AAA,32,16,17,48,5,0,5,0.1041666666666666,1.0,0.1041666666666666,0,-3
659070,Ben Bracewell,2019,AAA,53,26,31,79,9,0,9,0.1139240506329113,1.0,0.1139240506329113,0,-3
659925,Dustin Crenshaw,2019,AAA,20,11,7,31,2,2,4,0.1290322580645161,0.5,0.064516129032258,0,-3
660494,Rogelio Armenteros,2019,AAA,55,22,17,77,8,1,9,0.1168831168831168,0.8888888888888888,0.1038961038961039,0,-3
660610,Carlos De Leon,2019,AAA,60,21,34,81,1,1,2,0.0246913580246913,0.5,0.0123456790123456,0,-3
660623,Huascar Ynoa,2019,AAA,49,26,15,75,4,2,6,0.08,0.6666666666666666,0.0533333333333333,0,-3
660761,José Suarez,2019,AAA,22,11,7,33,2,2,4,0.1212121212121212,0.5,0.0606060606060606,0,-3
660850,Juan Robles,2019,AAA,23,15,23,38,2,1,3,0.0789473684210526,0.6666666666666666,0.0526315789473684,0,-3
660853,Enyel De Los Santos,2019,AAA,60,20,19,80,7,1,8,0.1,0.875,0.0875,0,-3
660871,Miguel Aguilar,2019,AAA,36,14,28,50,2,0,2,0.04,1.0,0.04,0,-3
660875,Jesús Reyes,2019,AAA,68,33,32,101,6,0,6,0.0594059405940594,1.0,0.0594059405940594,0,-3
660995,Nathanael Santiago,2019,AAA,27,18,22,45,0,0,0,0.0,,0.0,0,-3
661269,Vladimir Gutierrez,2019,AAA,74,56,26,130,22,3,25,0.1923076923076923,0.88,0.1692307692307692,0,-3
661536,Melvin Adón,2019,AAA,9,7,6,16,0,0,0,0.0,,0.0,0,-3
662144,Brian Keller,2019,AAA,27,10,5,37,3,0,3,0.081081081081081,1.0,0.081081081081081,0,-3
662253,Andrés Muñoz,2019,AAA,10,6,12,16,0,1,1,0.0625,0.0,0.0,0,-3
662964,Francisco Haro,2019,AAA,47,26,48,73,5,3,8,0.1095890410958904,0.625,0.0684931506849315,0,-3
663319,Craig Brooks,2019,AAA,18,6,14,24,0,0,0,0.0,,0.0,0,-3
663366,Beau Burrows,2019,AAA,37,20,15,57,0,1,1,0.0175438596491228,0.0,0.0,0,-3
663391,Spencer Jones,2019,AAA,26,18,9,44,5,0,5,0.1136363636363636,1.0,0.1136363636363636,0,-3
663393,Justin Donatella,2019,AAA,26,14,9,40,2,0,2,0.05,1.0,0.05,0,-3
663398,Luke Leftwich,2019,AAA,15,12,11,27,2,0,2,0.074074074074074,1.0,0.074074074074074,0,-3
663399,Brandon Waddell,2019,AAA,44,19,24,63,4,1,5,0.0793650793650793,0.8,0.0634920634920634,0,-3
663432,Tanner Rainey,2019,AAA,11,9,13,20,2,0,2,0.1,1.0,0.1,0,-3
663465,Kolby Allard,2019,AAA,79,29,21,108,4,7,11,0.1018518518518518,0.3636363636363636,0.037037037037037,0,-3
663531,Logan Allen,2019,AAA,56,26,18,82,3,0,3,0.0365853658536585,1.0,0.0365853658536585,0,-3
663567,Peter Lambert,2019,AAA,39,14,11,53,1,4,5,0.0943396226415094,0.2,0.0188679245283018,0,-3
663734,Nick Neidert,2019,AAA,29,16,9,45,1,3,4,0.0888888888888888,0.25,0.0222222222222222,0,-3
663765,Jake Woodford,2019,AAA,87,37,26,124,3,3,6,0.0483870967741935,0.5,0.0241935483870967,0,-3
663776,Patrick Sandoval,2019,AAA,47,29,15,76,1,1,2,0.0263157894736842,0.5,0.0131578947368421,0,-3
663894,Ryley Gilliam,2019,AAA,9,7,9,16,1,1,2,0.125,0.5,0.0625,0,-3
663992,Richard Lovelady,2019,AAA,19,11,13,30,0,0,0,0.0,,0.0,0,-3
664039,Geno Encina,2019,AAA,73,34,29,107,5,0,5,0.0467289719626168,1.0,0.0467289719626168,0,-3
664042,Travis Lakins Sr.,2019,AAA,28,23,28,51,1,2,3,0.0588235294117647,0.3333333333333333,0.0196078431372549,0,-3
664045,Thomas Eshelman,2019,AAA,27,18,11,45,3,1,4,0.0888888888888888,0.75,0.0666666666666666,0,-3
664054,Cody Stashak,2019,AAA,6,4,6,10,0,0,0,0.0,,0.0,0,-3
664062,Tony Gonsolin,2019,AAA,22,13,13,35,5,0,5,0.1428571428571428,1.0,0.1428571428571428,0,-3
664069,Ben Braymer,2019,AAA,44,20,13,64,4,4,8,0.125,0.5,0.0625,0,-3
664074,Cody Ponce,2019,AAA,12,7,3,19,3,0,3,0.1578947368421052,1.0,0.1578947368421052,0,-3
664092,Sean Poppen,2019,AAA,49,13,12,62,2,0,2,0.032258064516129,1.0,0.032258064516129,0,-3
664102,Adam Hofacket,2019,AAA,11,1,5,12,0,0,0,0.0,,0.0,0,-3
664110,Brandon Quintero,2019,AAA,38,15,27,53,2,0,2,0.0377358490566037,1.0,0.0377358490566037,0,-3
664121,Seth McGarry,2019,AAA,37,22,17,59,4,3,7,0.1186440677966101,0.5714285714285714,0.0677966101694915,0,-3
664126,Pete Fairbanks,2019,AAA,11,10,10,21,2,0,2,0.0952380952380952,1.0,0.0952380952380952,0,-3
664129,Geoff Hartlieb,2019,AAA,27,12,22,39,0,1,1,0.0256410256410256,0.0,0.0,0,-3
664139,Ian Gibaut,2019,AAA,16,7,11,23,4,0,4,0.1739130434782608,1.0,0.1739130434782608,0,-3
664141,JT Brubaker,2019,AAA,12,4,4,16,2,0,2,0.125,1.0,0.125,0,-3
664144,Jon Olczak,2019,AAA,26,14,17,40,3,0,3,0.075,1.0,0.075,0,-3
664157,Travis Bergen,2019,AAA,8,7,11,15,4,0,4,0.2666666666666666,1.0,0.2666666666666666,0,-3
664161,Matt Swarmer,2019,AAA,78,41,27,119,5,0,5,0.042016806722689,1.0,0.042016806722689,0,-3
664180,Matt Hall,2019,AAA,53,27,24,80,6,2,8,0.1,0.75,0.075,0,-3
664196,Tanner Anderson,2019,AAA,69,26,19,95,0,1,1,0.0105263157894736,0.0,0.0,0,-3
664199,Taylor Clarke,2019,AAA,14,14,7,28,1,0,1,0.0357142857142857,1.0,0.0357142857142857,0,-3
664208,Phil Maton,2019,AAA,17,2,13,19,1,0,1,0.0526315789473684,1.0,0.0526315789473684,0,-3
664219,Corey Taylor,2019,AAA,14,5,8,19,0,0,0,0.0,,0.0,0,-3
664236,Matthew Kent,2019,AAA,25,11,6,36,1,1,2,0.0555555555555555,0.5,0.0277777777777777,0,-3
664252,Tony Guerra,2019,AAA,21,5,12,26,2,0,2,0.0769230769230769,1.0,0.0769230769230769,0,-3
664285,Framber Valdez,2019,AAA,22,11,8,33,1,1,2,0.0606060606060606,0.5,0.0303030303030303,0,-3
664353,José Urquidy,2019,AAA,29,13,13,42,1,1,2,0.0476190476190476,0.5,0.0238095238095238,0,-3
664475,Edgar Torres,2019,AAA,42,21,43,63,1,1,2,0.0317460317460317,0.5,0.0158730158730158,0,-3
664482,Gonzalo Ochoa,2019,AAA,5,5,5,10,0,0,0,0.0,,0.0,0,-3
664682,Ryan Meisinger,2019,AAA,21,13,15,34,3,0,3,0.088235294117647,1.0,0.088235294117647,0,-3
664701,Ben Taylor,2019,AAA,38,12,29,50,3,1,4,0.08,0.75,0.06,0,-3
664823,David Gutierrez,2019,AAA,6,4,5,10,0,0,0,0.0,,0.0,0,-3
664843,Jerry Keel,2019,AAA,121,61,29,182,3,1,4,0.0219780219780219,0.75,0.0164835164835164,0,-3
664849,Danny Young,2019,AAA,9,2,6,11,1,0,1,0.0909090909090909,1.0,0.0909090909090909,0,-3
664852,Jay Flaa,2019,AAA,34,17,19,51,3,1,4,0.0784313725490196,0.75,0.0588235294117647,0,-3
664854,Ryan Helsley,2019,AAA,26,13,13,39,2,1,3,0.0769230769230769,0.6666666666666666,0.0512820512820512,0,-3
664856,Chance Adams,2019,AAA,55,24,15,79,6,2,8,0.1012658227848101,0.75,0.0759493670886076,0,-3
664871,Kyle Dowdy,2019,AAA,15,3,6,18,0,1,1,0.0555555555555555,0.0,0.0,0,-3
664875,Justin Lawrence,2019,AAA,12,7,7,19,0,0,0,0.0,,0.0,0,-3
664904,Josh Roeder,2019,AAA,11,1,3,12,0,0,0,0.0,,0.0,0,-3
664910,Logan Cozart,2019,AAA,16,9,11,25,0,0,0,0.0,,0.0,0,-3
664918,Kyle Keller,2019,AAA,19,12,17,31,4,1,5,0.1612903225806451,0.8,0.1290322580645161,0,-3
664940,Kurt Hoekstra,2019,AAA,9,1,3,10,0,1,1,0.1,0.0,0.0,0,-3
664942,James Naile,2019,AAA,12,6,3,18,0,1,1,0.0555555555555555,0.0,0.0,0,-3
664944,Cam Vieaux,2019,AAA,32,21,13,53,2,0,2,0.0377358490566037,1.0,0.0377358490566037,0,-3
664948,Anthony Misiewicz,2019,AAA,60,27,19,87,8,1,9,0.1034482758620689,0.8888888888888888,0.0919540229885057,0,-3
664977,Blake Cederlind,2019,AAA,9,5,3,14,2,0,2,0.1428571428571428,1.0,0.1428571428571428,0,-3
665001,Trevor Kelley,2019,AAA,36,20,34,56,1,1,2,0.0357142857142857,0.5,0.0178571428571428,0,-3
665004,Guillermo Trujillo,2019,AAA,7,3,4,10,0,0,0,0.0,,0.0,0,-3
665030,Winston Lavendier,2019,AAA,18,8,13,26,0,0,0,0.0,,0.0,0,-3
665045,Corey Copping,2019,AAA,21,8,14,29,3,0,3,0.1034482758620689,1.0,0.1034482758620689,0,-3
665120,Jared Walsh,2019,AAA,10,5,8,15,0,0,0,0.0,,0.0,0,-3
665142,Adam Lau,2019,AAA,14,7,5,21,2,1,3,0.1428571428571428,0.6666666666666666,0.0952380952380952,0,-3
665152,Dean Kremer,2019,AAA,14,9,4,23,0,0,0,0.0,,0.0,0,-3
665240,Yoanys Quiala,2019,AAA,61,26,19,87,1,0,1,0.0114942528735632,1.0,0.0114942528735632,0,-3
665290,Brad Kuntz,2019,AAA,7,4,2,11,0,0,0,0.0,,0.0,0,-3
665417,Kyle Kubat,2019,AAA,38,22,12,60,3,2,5,0.0833333333333333,0.6,0.05,0,-3
665620,Deivi García,2019,AAA,21,18,11,39,6,0,6,0.1538461538461538,1.0,0.1538461538461538,0,-3
665661,Shea Spitzbarth,2019,AAA,17,10,14,27,1,0,1,0.037037037037037,1.0,0.037037037037037,0,-3
665702,Fernando Irazoqui,2019,AAA,29,16,22,45,8,1,9,0.2,0.8888888888888888,0.1777777777777777,0,-3
665712,Juan Lopez,2019,AAA,28,14,21,42,2,1,3,0.0714285714285714,0.6666666666666666,0.0476190476190476,0,-3
665759,Ramón Rosso,2019,AAA,53,25,14,78,5,0,5,0.0641025641025641,1.0,0.0641025641025641,0,-3
666081,Adam Quintana,2019,AAA,50,25,30,75,6,2,8,0.1066666666666666,0.75,0.08,0,-3
666090,Saul Castellanos,2019,AAA,45,23,19,68,6,1,7,0.1029411764705882,0.8571428571428571,0.088235294117647,0,-3
666120,Ian Anderson,2019,AAA,12,10,5,22,0,0,0,0.0,,0.0,0,-3
666200,Jesús Luzardo,2019,AAA,14,12,6,26,2,0,2,0.0769230769230769,1.0,0.0769230769230769,0,-3
666215,Forrest Whitley,2019,AAA,17,13,7,30,3,0,3,0.1,1.0,0.1,0,-3
666746,Rogelio Bernal,2019,AAA,9,6,7,15,1,0,1,0.0666666666666666,1.0,0.0666666666666666,0,-3
667376,Miguel Sánchez,2019,AAA,35,24,24,59,7,0,7,0.1186440677966101,1.0,0.1186440677966101,0,-3
667427,Zach Jackson,2019,AAA,35,23,35,58,10,0,10,0.1724137931034483,1.0,0.1724137931034483,0,-3
667498,Robert Dugger,2019,AAA,37,23,10,60,2,2,4,0.0666666666666666,0.5,0.0333333333333333,0,-3
667595,Kevin Lenik,2019,AAA,8,4,5,12,0,0,0,0.0,,0.0,0,-3
667677,Zac Houston,2019,AAA,12,9,12,21,0,0,0,0.0,,0.0,0,-3
667904,Jose Isidro Marquez,2019,AAA,11,8,12,19,1,0,1,0.0526315789473684,1.0,0.0526315789473684,0,-3
667910,Juan Macias,2019,AAA,52,31,23,83,3,2,5,0.0602409638554216,0.6,0.036144578313253,0,-3
667918,Erick Casillas,2019,AAA,23,19,26,42,1,0,1,0.0238095238095238,1.0,0.0238095238095238,0,-3
668020,Isaac Rodriguez,2019,AAA,14,15,17,29,3,1,4,0.1379310344827586,0.75,0.1034482758620689,0,-3
668155,Alberto Leyva,2019,AAA,28,12,26,40,2,3,5,0.125,0.4,0.05,0,-3
668338,Tyson Miller,2019,AAA,34,15,11,49,4,1,5,0.1020408163265306,0.8,0.0816326530612244,0,-3
668665,Stephen Nogosek,2019,AAA,11,5,10,16,0,0,0,0.0,,0.0,0,-3
668676,Zach Plesac,2019,AAA,9,3,4,12,1,0,1,0.0833333333333333,1.0,0.0833333333333333,0,-3
668678,Zac Gallen,2019,AAA,28,14,14,42,5,2,7,0.1666666666666666,0.7142857142857143,0.119047619047619,0,-3
668683,Jeremy Walker,2019,AAA,19,7,8,26,2,0,2,0.0769230769230769,1.0,0.0769230769230769,0,-3
668684,Tanner Tully,2019,AAA,8,4,3,12,0,0,0,0.0,,0.0,0,-3
668862,Luke Heimlich,2019,AAA,89,36,21,125,9,7,16,0.128,0.5625,0.072,0,-3
668941,JoJo Romero,2019,AAA,52,26,13,78,3,2,5,0.0641025641025641,0.6,0.0384615384615384,0,-3
669054,Matthew Gorst,2019,AAA,18,5,8,23,0,1,1,0.0434782608695652,0.0,0.0,0,-3
669060,Bryse Wilson,2019,AAA,68,29,21,97,3,0,3,0.0309278350515463,1.0,0.0309278350515463,0,-3
669130,Mike Kaelin,2019,AAA,4,7,2,11,0,0,0,0.0,,0.0,0,-3
669145,Bruce Zimmermann,2019,AAA,32,9,7,41,1,0,1,0.024390243902439,1.0,0.024390243902439,0,-3
669160,Dustin May,2019,AAA,16,5,5,21,1,2,3,0.1428571428571428,0.3333333333333333,0.0476190476190476,0,-3
669203,Corbin Burnes,2019,AAA,16,10,5,26,4,2,6,0.2307692307692307,0.6666666666666666,0.1538461538461538,0,-3
669211,Keegan Akin,2019,AAA,63,31,25,94,6,2,8,0.0851063829787234,0.75,0.0638297872340425,0,-3
669214,Conner Menez,2019,AAA,35,13,12,48,2,2,4,0.0833333333333333,0.5,0.0416666666666666,0,-3
669270,Joel Kuhnel,2019,AAA,8,7,9,15,0,0,0,0.0,,0.0,0,-3
669276,Dylan Lee,2019,AAA,16,9,11,25,1,1,2,0.08,0.5,0.04,0,-3
669483,Marcos Machado,2019,AAA,45,31,19,76,3,3,6,0.0789473684210526,0.5,0.0394736842105263,0,-3
669618,Joe Barlow,2019,AAA,20,9,15,29,6,0,6,0.2068965517241379,1.0,0.2068965517241379,0,-3
669725,Thomas Jankins,2019,AAA,83,40,23,123,1,4,5,0.040650406504065,0.2,0.008130081300813,0,-3
669728,Dakota Mekkes,2019,AAA,33,19,25,52,2,0,2,0.0384615384615384,1.0,0.0384615384615384,0,-3
669746,Tommy Eveld,2019,AAA,13,13,11,26,4,0,4,0.1538461538461538,1.0,0.1538461538461538,0,-3
669854,Ronel Blanco,2019,AAA,19,10,15,29,2,0,2,0.0689655172413793,1.0,0.0689655172413793,0,-3
669912,Kirby Snead,2019,AAA,42,15,28,57,3,1,4,0.0701754385964912,0.75,0.0526315789473684,0,-3
669920,Jason Alexander,2019,AAA,53,38,12,91,1,3,4,0.0439560439560439,0.25,0.0109890109890109,0,-3
669952,Mitch White,2019,AAA,38,20,16,58,4,1,5,0.0862068965517241,0.8,0.0689655172413793,0,-3
670036,Matt Festa,2019,AAA,13,12,14,25,2,0,2,0.08,1.0,0.08,0,-3
670057,Ryan Hartman,2019,AAA,78,33,24,111,5,0,5,0.045045045045045,1.0,0.045045045045045,0,-3
670061,Duncan Robinson,2019,AAA,12,9,5,21,0,1,1,0.0476190476190476,0.0,0.0,0,-3
670119,Connor Grey,2019,AAA,15,10,7,25,2,0,2,0.08,1.0,0.08,0,-3
670159,Carson LaRue,2019,AAA,25,13,7,38,0,2,2,0.0526315789473684,0.0,0.0,0,-3
670161,Parker Dunshee,2019,AAA,51,20,19,71,4,3,7,0.0985915492957746,0.5714285714285714,0.056338028169014,0,-3
670167,John Schreiber,2019,AAA,20,15,22,35,1,0,1,0.0285714285714285,1.0,0.0285714285714285,0,-3
670179,Justin Kelly,2019,AAA,11,4,12,15,0,1,1,0.0666666666666666,0.0,0.0,0,-3
670328,Juan Gámez,2019,AAA,40,14,29,54,1,1,2,0.037037037037037,0.5,0.0185185185185185,0,-3
670329,Rico Garcia,2019,AAA,42,19,12,61,2,1,3,0.0491803278688524,0.6666666666666666,0.0327868852459016,0,-3
670377,Evan Miller,2019,AAA,9,2,4,11,0,0,0,0.0,,0.0,0,-3
670426,Phillip Diehl,2019,AAA,25,12,22,37,1,0,1,0.027027027027027,1.0,0.027027027027027,0,-3
670456,JD Hammer,2019,AAA,13,9,12,22,2,0,2,0.0909090909090909,1.0,0.0909090909090909,0,-3
670617,Enrique Oquendo,2019,AAA,18,15,17,33,5,1,6,0.1818181818181818,0.8333333333333334,0.1515151515151515,0,-3
670620,Joseph Camacho,2019,AAA,24,18,29,42,1,0,1,0.0238095238095238,1.0,0.0238095238095238,0,-3
670651,Anthony Shew,2019,AAA,27,13,10,40,2,1,3,0.075,0.6666666666666666,0.05,0,-3
670766,Darren McCaughan,2019,AAA,24,15,9,39,1,0,1,0.0256410256410256,1.0,0.0256410256410256,0,-3
670772,Henry Omana,2019,AAA,10,8,7,18,3,1,4,0.2222222222222222,0.75,0.1666666666666666,0,-3
670866,Ryan Atkinson,2019,AAA,23,12,16,35,0,1,1,0.0285714285714285,0.0,0.0,0,-3
671760,Mario Jimenez,2019,AAA,38,16,31,54,1,0,1,0.0185185185185185,1.0,0.0185185185185185,0,-3
672335,Cionel Pérez,2019,AAA,35,11,12,46,1,1,2,0.0434782608695652,0.5,0.0217391304347826,0,-3
672391,Kaleb Ort,2019,AAA,23,10,17,33,4,0,4,0.1212121212121212,1.0,0.1212121212121212,0,-3
672911,Jesus Cruz,2019,AAA,43,24,32,67,3,1,4,0.0597014925373134,0.75,0.044776119402985,0,-3
673140,Elian Leyva,2019,AAA,48,28,16,76,7,1,8,0.1052631578947368,0.875,0.0921052631578947,0,-3
673316,Luke Barker,2019,AAA,11,4,8,15,2,0,2,0.1333333333333333,1.0,0.1333333333333333,0,-3
673603,Luis Romero,2019,AAA,39,21,29,60,3,1,4,0.0666666666666666,0.75,0.05,0,-3
674267,Carlos Chavez,2019,AAA,40,22,19,62,0,0,0,0.0,,0.0,0,-3
674268,Chris Rocha,2019,AAA,23,18,17,41,1,0,1,0.024390243902439,1.0,0.024390243902439,0,-3
674476,Jonathan Partida,2019,AAA,12,5,14,17,0,0,0,0.0,,0.0,0,-3
674478,Luis Payan,2019,AAA,62,33,22,95,11,1,12,0.1263157894736842,0.9166666666666666,0.1157894736842105,0,-3
674481,Daniel Flores,2019,AAA,24,7,16,31,2,0,2,0.064516129032258,1.0,0.064516129032258,0,-3
674485,Mario Morales,2019,AAA,30,17,28,47,1,1,2,0.0425531914893617,0.5,0.0212765957446808,0,-3
674499,Luis De Luna,2019,AAA,9,3,6,12,0,0,0,0.0,,0.0,0,-3
674500,Daniel Diaz,2019,AAA,35,18,31,53,1,0,1,0.0188679245283018,1.0,0.0188679245283018,0,-3
674503,Alejandro Chavarria,2019,AAA,38,18,33,56,5,0,5,0.0892857142857142,1.0,0.0892857142857142,0,-3
674505,Refugio Marin,2019,AAA,21,8,14,29,1,1,2,0.0689655172413793,0.5,0.0344827586206896,0,-3
675866,Jesus Alcantar,2019,AAA,33,15,22,48,1,0,1,0.0208333333333333,1.0,0.0208333333333333,0,-3
675871,Romario Gil,2019,AAA,47,18,16,65,6,1,7,0.1076923076923077,0.8571428571428571,0.0923076923076923,0,-3
675916,James Karinchak,2019,AAA,11,7,8,18,2,0,2,0.1111111111111111,1.0,0.1111111111111111,0,-3
675971,Kyle Dohy,2019,AAA,47,34,35,81,8,1,9,0.1111111111111111,0.8888888888888888,0.0987654320987654,0,-3
676103,Damon Jones,2019,AAA,26,12,8,38,2,0,2,0.0526315789473684,1.0,0.0526315789473684,0,-3
676190,Carlos Morales,2019,AAA,15,10,7,25,0,0,0,0.0,,0.0,0,-3
676220,Seth Elledge,2019,AAA,25,13,13,38,3,4,7,0.1842105263157894,0.4285714285714285,0.0789473684210526,0,-3
676358,Evan Kruczynski,2019,AAA,24,10,7,34,1,0,1,0.0294117647058823,1.0,0.0294117647058823,0,-3
676596,Josh Fleming,2019,AAA,13,4,4,17,1,0,1,0.0588235294117647,1.0,0.0588235294117647,0,-3
676607,Hunter Schryver,2019,AAA,9,7,5,16,0,0,0,0.0,,0.0,0,-3
676620,Blake Weiman,2019,AAA,8,2,6,10,0,0,0,0.0,,0.0,0,-3
676644,Stephen Villines,2019,AAA,11,11,8,22,0,0,0,0.0,,0.0,0,-3
676709,Ty Tice,2019,AAA,22,15,16,37,0,0,0,0.0,,0.0,0,-3
676744,Tyler Stevens,2019,AAA,12,3,7,15,0,0,0,0.0,,0.0,0,-3
676886,Jeremy Beasley,2019,AAA,7,6,3,13,0,0,0,0.0,,0.0,0,-3
677012,Jonathan Cheshire,2019,AAA,10,1,4,11,0,0,0,0.0,,0.0,0,-3
677365,Tanner Duncan,2019,AAA,9,7,9,16,0,0,0,0.0,,0.0,0,-3
677369,Austin Warner,2019,AAA,39,20,11,59,1,1,2,0.0338983050847457,0.5,0.0169491525423728,0,-3
677415,Kit Scheetz,2019,AAA,19,12,11,31,3,0,3,0.0967741935483871,1.0,0.0967741935483871,0,-3
677742,Tyler Zombro,2019,AAA,4,6,4,10,1,0,1,0.1,1.0,0.1,0,-3
677744,Jesus Juarez,2019,AAA,8,3,7,11,1,0,1,0.0909090909090909,1.0,0.0909090909090909,0,-3
677867,Max Herrmann,2019,AAA,20,7,4,27,1,1,2,0.074074074074074,0.5,0.037037037037037,0,-3
677916,Gerardo Gutierrez,2019,AAA,15,4,9,19,1,1,2,0.1052631578947368,0.5,0.0526315789473684,0,-3
677976,Randy Dobnak,2019,AAA,23,15,9,38,0,0,0,0.0,,0.0,0,-3
678340,Robert Garcia,2019,AAA,7,6,5,13,0,0,0,0.0,,0.0,0,-3
678450,Andy Salcido,2019,AAA,16,13,13,29,1,0,1,0.0344827586206896,1.0,0.0344827586206896,0,-3
678455,Carlos Stiff Rodriguez,2019,AAA,13,7,12,20,0,0,0,0.0,,0.0,0,-3
679001,Braulio Torres-Perez,2019,AAA,9,8,15,17,1,0,1,0.0588235294117647,1.0,0.0588235294117647,0,-3
679943,Jose Ramirez,2019,AAA,9,4,5,13,0,0,0,0.0,,0.0,0,-3
680024,Jose Frutos,2019,AAA,21,12,12,33,1,0,1,0.0303030303030303,1.0,0.0303030303030303,0,-3
680026,Angel Landazuri,2019,AAA,32,15,21,47,3,0,3,0.0638297872340425,1.0,0.0638297872340425,0,-3
680028,Edgar Acosta,2019,AAA,27,11,19,38,1,1,2,0.0526315789473684,0.5,0.0263157894736842,0,-3
680366,Esteban Romero,2019,AAA,20,8,14,28,1,1,2,0.0714285714285714,0.5,0.0357142857142857,0,-3
680391,Francisco Gomez,2019,AAA,26,7,9,33,0,2,2,0.0606060606060606,0.0,0.0,0,-3
681124,Christian Prado,2019,AAA,22,14,21,36,1,3,4,0.1111111111111111,0.25,0.0277777777777777,0,-3
682171,Penn Murfee,2019,AAA,9,3,5,12,1,0,1,0.0833333333333333,1.0,0.0833333333333333,0,-3
682747,Normand Mendoza,2019,AAA,24,11,16,35,5,0,5,0.1428571428571428,1.0,0.1428571428571428,0,-3
682777,Octavio Becerra,2019,AAA,10,2,6,12,0,0,0,0.0,,0.0,0,-3
682779,Jose Luna,2019,AAA,7,5,6,12,1,0,1,0.0833333333333333,1.0,0.0833333333333333,0,-3
683030,Edwyn Valle,2019,AAA,9,7,5,16,2,0,2,0.125,1.0,0.125,0,-3
683139,Joel Munoz,2019,AAA,9,4,8,13,2,0,2,0.1538461538461538,1.0,0.1538461538461538,0,-3
684118,Victor Buelna,2019,AAA,20,11,8,31,4,0,4,0.1290322580645161,1.0,0.1290322580645161,0,-3
685338,Justin Vernia,2019,AAA,5,6,2,11,1,1,2,0.1818181818181818,0.5,0.0909090909090909,0,-3
685690,Vinnie Tarantola,2019,AAA,6,4,4,10,0,0,0,0.0,,0.0,0,-3
685692,Vicente Valenzuela,2019,AAA,17,7,7,24,2,1,3,0.125,0.6666666666666666,0.0833333333333333,0,-3
685698,Edgar Martinez,2019,AAA,35,21,20,56,2,0,2,0.0357142857142857,1.0,0.0357142857142857,0,-3
685829,Irvin Machuca,2019,AAA,33,21,25,54,2,0,2,0.037037037037037,1.0,0.037037037037037,0,-3
686231,Ferlon Gijsbertha,2019,AAA,8,6,7,14,0,0,0,0.0,,0.0,0,-3
686526,Misael Lopez,2019,AAA,7,6,6,13,1,0,1,0.0769230769230769,1.0,0.0769230769230769,0,-3
687305,Miguel Esparza,2019,AAA,11,6,11,17,0,0,0,0.0,,0.0,0,-3
690909,Daniel Cruz,2019,AAA,14,6,12,20,1,2,3,0.15,0.3333333333333333,0.05,0,-3
691223,Jose Miguel Sanchez,2019,AAA,9,4,6,13,0,0,0,0.0,,0.0,0,-3
691388,Jonas Garibay,2019,AAA,13,5,6,18,0,0,0,0.0,,0.0,0,-3
346847,Joe Beimel,2021,AAA,10,1,8,11,2,0,2,0.1818181818181818,1.0,0.1818181818181818,0,-1
431148,Scott Kazmir,2021,AAA,32,13,12,45,1,1,2,0.0444444444444444,0.5,0.0222222222222222,0,-1
445926,Jesse Chavez,2021,AAA,12,4,10,16,1,1,2,0.125,0.5,0.0625,0,-1
446185,Logan Ondrusek,2021,AAA,28,13,9,41,0,1,1,0.024390243902439,0.0,0.0,0,-1
452027,Andrew Albers,2021,AAA,57,29,18,86,2,2,4,0.0465116279069767,0.5,0.0232558139534883,0,-1
453214,Steven Wright,2021,AAA,50,32,17,82,8,0,8,0.0975609756097561,1.0,0.0975609756097561,0,-1
453281,Wade LeBlanc,2021,AAA,13,7,6,20,1,0,1,0.05,1.0,0.05,0,-1
453307,David Huff,2021,AAA,30,12,13,42,0,0,0,0.0,,0.0,0,-1
456701,Homer Bailey,2021,AAA,34,19,11,53,4,2,6,0.1132075471698113,0.6666666666666666,0.0754716981132075,0,-1
458676,Josh Lindblom,2021,AAA,37,30,20,67,5,0,5,0.0746268656716417,1.0,0.0746268656716417,0,-1
472551,Fernando Abad,2021,AAA,13,10,14,23,2,0,2,0.0869565217391304,1.0,0.0869565217391304,0,-1
472610,Luis García,2021,AAA,9,4,8,13,1,0,1,0.0769230769230769,1.0,0.0769230769230769,0,-1
474699,Vance Worley,2021,AAA,71,29,16,100,12,3,15,0.15,0.8,0.12,0,-1
476589,Adam Warren,2021,AAA,43,23,28,66,6,1,7,0.106060606060606,0.8571428571428571,0.0909090909090909,0,-1
476594,Robert Stock,2021,AAA,23,8,8,31,1,0,1,0.032258064516129,1.0,0.032258064516129,0,-1
488748,Ryan Buchter,2021,AAA,8,4,8,12,1,0,1,0.0833333333333333,1.0,0.0833333333333333,0,-1
489295,Brian Schlitter,2021,AAA,43,20,28,63,3,0,3,0.0476190476190476,1.0,0.0476190476190476,0,-1
491703,Neftalí Feliz,2021,AAA,20,5,18,25,0,0,0,0.0,,0.0,0,-1
502083,Zach McAllister,2021,AAA,10,1,7,11,2,0,2,0.1818181818181818,1.0,0.1818181818181818,0,-1
502212,Austin Bibens-Dirkx,2021,AAA,65,34,24,99,10,0,10,0.101010101010101,1.0,0.101010101010101,0,-1
502253,Alex Sanabia,2021,AAA,20,13,9,33,1,1,2,0.0606060606060606,0.5,0.0303030303030303,0,-1
502522,Justin Miller,2021,AAA,10,6,11,16,5,0,5,0.3125,1.0,0.3125,0,-1
502578,Aaron Barrett,2021,AAA,23,11,18,34,3,1,4,0.1176470588235294,0.75,0.088235294117647,0,-1
502593,Jake Petricka,2021,AAA,28,12,18,40,3,0,3,0.075,1.0,0.075,0,-1
502624,Chase Anderson,2021,AAA,24,10,10,34,7,2,9,0.2647058823529412,0.7777777777777778,0.2058823529411764,0,-1
502748,Brad Peacock,2021,AAA,23,10,11,33,3,1,4,0.1212121212121212,0.75,0.0909090909090909,0,-1
503449,Wily Peralta,2021,AAA,10,4,5,14,0,0,0,0.0,,0.0,0,-1
503569,Rafael Dolis,2021,AAA,9,7,7,16,3,0,3,0.1875,1.0,0.1875,0,-1
505447,Brandon Dickson,2021,AAA,11,6,8,17,0,0,0,0.0,,0.0,0,-1
514981,Diego Moreno,2021,AAA,17,6,14,23,4,1,5,0.217391304347826,0.8,0.1739130434782608,0,-1
516685,Nelson Gonzalez,2021,AAA,20,6,14,26,0,0,0,0.0,,0.0,0,-1
518435,Manny Barreda,2021,AAA,25,18,20,43,4,1,5,0.1162790697674418,0.8,0.0930232558139534,0,-1
518464,Seth Blair,2021,AAA,25,13,13,38,14,2,16,0.4210526315789473,0.875,0.3684210526315789,0,-1
518489,Ryan Brasier,2021,AAA,11,1,4,12,1,0,1,0.0833333333333333,1.0,0.0833333333333333,0,-1
518649,Brett Eibner,2021,AAA,5,7,7,12,1,0,1,0.0833333333333333,1.0,0.0833333333333333,0,-1
518748,Justin Grimm,2021,AAA,21,16,21,37,5,0,5,0.1351351351351351,1.0,0.1351351351351351,0,-1
519008,T.J. McFarland,2021,AAA,18,12,12,30,3,0,3,0.1,1.0,0.1,0,-1
519043,Matt Moore,2021,AAA,12,3,5,15,1,1,2,0.1333333333333333,0.5,0.0666666666666666,0,-1
519263,A.J. Schugel,2021,AAA,20,11,12,31,3,0,3,0.0967741935483871,1.0,0.0967741935483871,0,-1
519393,Marcus Walden,2021,AAA,50,21,29,71,14,2,16,0.2253521126760563,0.875,0.1971830985915492,0,-1
520980,Pedro Báez,2021,AAA,6,4,7,10,1,0,1,0.1,1.0,0.1,0,-1
528748,Humberto Castellanos,2021,AAA,20,16,12,36,1,1,2,0.0555555555555555,0.5,0.0277777777777777,0,-1
533167,Matt Shoemaker,2021,AAA,40,19,13,59,3,4,7,0.1186440677966101,0.4285714285714285,0.0508474576271186,0,-1
534812,Kevin Quackenbush,2021,AAA,27,13,28,40,1,2,3,0.075,0.3333333333333333,0.025,0,-1
534947,Tim Adleman,2021,AAA,14,13,20,27,3,0,3,0.1111111111111111,1.0,0.1111111111111111,0,-1
542888,Shawn Armstrong,2021,AAA,18,11,14,29,1,0,1,0.0344827586206896,1.0,0.0344827586206896,0,-1
543022,Tyler Chatwood,2021,AAA,12,6,8,18,0,0,0,0.0,,0.0,0,-1
543045,Adam Conley,2021,AAA,22,7,16,29,7,0,7,0.2413793103448276,1.0,0.2413793103448276,0,-1
543056,Danny Coulombe,2021,AAA,7,5,6,12,0,0,0,0.0,,0.0,0,-1
543208,Sam Gaviglio,2021,AAA,22,7,5,29,2,0,2,0.0689655172413793,1.0,0.0689655172413793,0,-1
543238,Anthony Gose,2021,AAA,21,6,15,27,0,0,0,0.0,,0.0,0,-1
543258,Preston Guilmet,2021,AAA,16,11,14,27,3,1,4,0.1481481481481481,0.75,0.1111111111111111,0,-1
543278,Blaine Hardy,2021,AAA,45,20,23,65,3,2,5,0.0769230769230769,0.6,0.0461538461538461,0,-1
543456,Kyle Lobstein,2021,AAA,29,22,27,51,4,0,4,0.0784313725490196,1.0,0.0784313725490196,0,-1
543548,Tommy Milone,2021,AAA,9,5,7,14,3,0,3,0.2142857142857142,1.0,0.2142857142857142,0,-1
543557,Mike Montgomery,2021,AAA,9,7,4,16,2,2,4,0.25,0.5,0.125,0,-1
543594,Sean Nolin,2021,AAA,31,12,10,43,2,1,3,0.0697674418604651,0.6666666666666666,0.0465116279069767,0,-1
543699,Tanner Roark,2021,AAA,30,11,17,41,6,1,7,0.1707317073170731,0.8571428571428571,0.1463414634146341,0,-1
543726,Robbie Ross Jr.,2021,AAA,23,18,18,41,2,0,2,0.048780487804878,1.0,0.048780487804878,0,-1
543734,Chris Rusin,2021,AAA,20,15,18,35,5,0,5,0.1428571428571428,1.0,0.1428571428571428,0,-1
543867,Nik Turley,2021,AAA,21,14,21,35,1,0,1,0.0285714285714285,1.0,0.0285714285714285,0,-1
543883,Nick Vincent,2021,AAA,37,14,27,51,1,0,1,0.0196078431372549,1.0,0.0196078431372549,0,-1
543901,Ryan Weber,2021,AAA,50,32,19,82,15,1,16,0.1951219512195122,0.9375,0.1829268292682926,0,-1
545064,Jairo Díaz,2021,AAA,6,4,5,10,0,0,0,0.0,,0.0,0,-1
545343,Louis Head,2021,AAA,8,3,9,11,0,1,1,0.0909090909090909,0.0,0.0,0,-1
545346,Zach Lee,2021,AAA,68,30,20,98,0,0,0,0.0,,0.0,0,-1
547007,Rob Whalen,2021,AAA,18,9,7,27,1,0,1,0.037037037037037,1.0,0.037037037037037,0,-1
547176,Daniel Camarena,2021,AAA,49,25,22,74,8,2,10,0.1351351351351351,0.8,0.1081081081081081,0,-1
547177,Phil Pfeifer,2021,AAA,14,8,5,22,0,0,0,0.0,,0.0,0,-1
547184,Michael Kelly,2021,AAA,30,12,24,42,5,1,6,0.1428571428571428,0.8333333333333334,0.119047619047619,0,-1
548337,Logan Verrett,2021,AAA,63,18,19,81,4,1,5,0.0617283950617283,0.8,0.0493827160493827,0,-1
554241,Andy Otero,2021,AAA,17,15,7,32,4,0,4,0.125,1.0,0.125,0,-1
570240,Félix Peña,2021,AAA,37,21,25,58,5,1,6,0.1034482758620689,0.8333333333333334,0.0862068965517241,0,-1
570488,Phillips Valdez,2021,AAA,16,7,11,23,1,0,1,0.0434782608695652,1.0,0.0434782608695652,0,-1
571439,R.J. Alvarez,2021,AAA,26,18,29,44,3,1,4,0.0909090909090909,0.75,0.0681818181818181,0,-1
571446,Mark Appel,2021,AAA,31,12,13,43,0,1,1,0.0232558139534883,0.0,0.0,0,-1
571479,Andrew Bellatti,2021,AAA,14,5,12,19,2,0,2,0.1052631578947368,1.0,0.1052631578947368,0,-1
571656,Buck Farmer,2021,AAA,15,9,14,24,3,0,3,0.125,1.0,0.125,0,-1
571676,Seth Frankoff,2021,AAA,23,7,8,30,3,0,3,0.1,1.0,0.1,0,-1
571800,Drew Hutchison,2021,AAA,57,31,19,88,6,4,10,0.1136363636363636,0.6,0.0681818181818181,0,-1
571825,James Jones,2021,AAA,13,6,10,19,0,0,0,0.0,,0.0,0,-1
571863,Matt Koch,2021,AAA,44,17,27,61,1,2,3,0.0491803278688524,0.3333333333333333,0.0163934426229508,0,-1
571871,Ian Krol,2021,AAA,18,6,15,24,1,0,1,0.0416666666666666,1.0,0.0416666666666666,0,-1
571882,Derek Law,2021,AAA,26,7,12,33,0,2,2,0.0606060606060606,0.0,0.0,0,-1
571917,Parker Markel,2021,AAA,31,22,30,53,8,2,10,0.1886792452830188,0.8,0.1509433962264151,0,-1
571945,Miles Mikolas,2021,AAA,9,6,4,15,2,0,2,0.1333333333333333,1.0,0.1333333333333333,0,-1
571946,Shelby Miller,2021,AAA,9,7,8,16,4,1,5,0.3125,0.8,0.25,0,-1
571948,Hoby Milner,2021,AAA,11,5,12,16,0,1,1,0.0625,0.0,0.0,0,-1
571951,Bryan Mitchell,2021,AAA,47,15,24,62,4,3,7,0.1129032258064516,0.5714285714285714,0.064516129032258,0,-1
571993,Chris Nunn,2021,AAA,15,6,11,21,2,0,2,0.0952380952380952,1.0,0.0952380952380952,0,-1
572021,James Pazos,2021,AAA,32,17,28,49,4,0,4,0.0816326530612244,1.0,0.0816326530612244,0,-1
572125,Sam Selman,2021,AAA,10,4,10,14,0,0,0,0.0,,0.0,0,-1
572383,Brian Moran,2021,AAA,29,11,24,40,4,0,4,0.1,1.0,0.1,0,-1
572406,Sam Wolff,2021,AAA,7,4,9,11,0,0,0,0.0,,0.0,0,-1
572750,Eddie Butler,2021,AAA,69,25,24,94,4,1,5,0.0531914893617021,0.8,0.0425531914893617,0,-1
573062,Aaron Northcraft,2021,AAA,12,9,10,21,0,1,1,0.0476190476190476,0.0,0.0,0,-1
573064,Vidal Nuño,2021,AAA,31,15,15,46,2,0,2,0.0434782608695652,1.0,0.0434782608695652,0,-1
573109,AJ Ramos,2021,AAA,34,21,26,55,8,0,8,0.1454545454545454,1.0,0.1454545454545454,0,-1
573127,Zac Rosscup,2021,AAA,20,8,18,28,4,0,4,0.1428571428571428,1.0,0.1428571428571428,0,-1
573668,Juan Minaya,2021,AAA,23,14,13,37,3,0,3,0.081081081081081,1.0,0.081081081081081,0,-1
580792,Nick Goody,2021,AAA,30,17,25,47,3,0,3,0.0638297872340425,1.0,0.0638297872340425,0,-1
584171,Hector Velázquez,2021,AAA,13,5,10,18,2,1,3,0.1666666666666666,0.6666666666666666,0.1111111111111111,0,-1
592105,Stetson Allie,2021,AAA,5,5,4,10,3,0,3,0.3,1.0,0.3,0,-1
592135,Cam Bedrosian,2021,AAA,9,9,12,18,0,1,1,0.0555555555555555,0.0,0.0,0,-1
592145,Jesse Biddle,2021,AAA,24,13,19,37,3,2,5,0.1351351351351351,0.6,0.081081081081081,0,-1
592165,Brandon Brennan,2021,AAA,33,15,21,48,6,0,6,0.125,1.0,0.125,0,-1
592169,Austin Brice,2021,AAA,21,10,18,31,5,1,6,0.1935483870967742,0.8333333333333334,0.1612903225806451,0,-1
592222,Alex Claudio,2021,AAA,6,5,4,11,0,0,0,0.0,,0.0,0,-1
592233,Stefan Crichton,2021,AAA,9,10,9,19,5,0,5,0.2631578947368421,1.0,0.2631578947368421,0,-1
592329,Jason García,2021,AAA,15,5,4,20,1,0,1,0.05,1.0,0.05,0,-1
592438,Chase Johnson,2021,AAA,34,20,18,54,2,0,2,0.037037037037037,1.0,0.037037037037037,0,-1
592455,Jake Kalish,2021,AAA,52,16,25,68,2,1,3,0.0441176470588235,0.6666666666666666,0.0294117647058823,0,-1
592464,Mike Kickham,2021,AAA,36,18,18,54,6,0,6,0.1111111111111111,1.0,0.1111111111111111,0,-1
592473,Adam Kolarek,2021,AAA,37,20,29,57,3,0,3,0.0526315789473684,1.0,0.0526315789473684,0,-1
592527,Michael Mariot,2021,AAA,54,30,19,84,3,1,4,0.0476190476190476,0.75,0.0357142857142857,0,-1
592570,Akeel Morris,2021,AAA,16,11,5,27,1,1,2,0.074074074074074,0.5,0.037037037037037,0,-1
592630,Ronald Peña,2021,AAA,38,14,19,52,6,0,6,0.1153846153846153,1.0,0.1153846153846153,0,-1
592644,Adam Plutko,2021,AAA,11,5,8,16,1,1,2,0.125,0.5,0.0625,0,-1
592712,Connor Sadzeck,2021,AAA,32,24,28,56,3,0,3,0.0535714285714285,1.0,0.0535714285714285,0,-1
592716,Adrian Sampson,2021,AAA,60,29,15,89,8,3,11,0.1235955056179775,0.7272727272727273,0.0898876404494382,0,-1
592717,Aaron Sanchez,2021,AAA,12,9,5,21,4,0,4,0.1904761904761904,1.0,0.1904761904761904,0,-1
592831,Konner Wade,2021,AAA,34,10,16,44,4,1,5,0.1136363636363636,0.8,0.0909090909090909,0,-1
592833,Bobby Wahl,2021,AAA,14,14,15,28,2,1,3,0.1071428571428571,0.6666666666666666,0.0714285714285714,0,-1
592848,Zack Weiss,2021,AAA,22,15,22,37,7,0,7,0.1891891891891892,1.0,0.1891891891891892,0,-1
592865,Taylor Williams,2021,AAA,7,6,7,13,1,1,2,0.1538461538461538,0.5,0.0769230769230769,0,-1
592866,Trevor Williams,2021,AAA,11,0,4,11,1,0,1,0.0909090909090909,1.0,0.0909090909090909,0,-1
592874,Tom Windle,2021,AAA,17,14,17,31,3,0,3,0.0967741935483871,1.0,0.0967741935483871,0,-1
592879,Asher Wojciechowski,2021,AAA,13,12,9,25,0,0,0,0.0,,0.0,0,-1
593163,Carlos Navas,2021,AAA,19,15,13,34,5,0,5,0.1470588235294117,1.0,0.1470588235294117,0,-1
593468,Claudio Custodio,2021,AAA,35,18,20,53,4,0,4,0.0754716981132075,1.0,0.0754716981132075,0,-1
593574,Luis González,2021,AAA,13,10,12,23,1,0,1,0.0434782608695652,1.0,0.0434782608695652,0,-1
593604,Alberto Baldonado,2021,AAA,18,9,15,27,1,0,1,0.037037037037037,1.0,0.037037037037037,0,-1
593619,Domingo Tapia,2021,AAA,26,10,15,36,2,0,2,0.0555555555555555,1.0,0.0555555555555555,0,-1
593833,Wander Suero,2021,AAA,8,3,6,11,3,1,4,0.3636363636363636,0.75,0.2727272727272727,0,-1
594027,Tayron Guerrero,2021,AAA,13,13,13,26,3,0,3,0.1153846153846153,1.0,0.1153846153846153,0,-1
594056,Reymin Guduan,2021,AAA,30,13,25,43,2,0,2,0.0465116279069767,1.0,0.0465116279069767,0,-1
594311,Jandel Gustave,2021,AAA,14,5,10,19,4,1,5,0.2631578947368421,0.8,0.2105263157894736,0,-1
594580,Sam Moll,2021,AAA,26,12,23,38,2,0,2,0.0526315789473684,1.0,0.0526315789473684,0,-1
594772,Jake Buchanan,2021,AAA,40,18,14,58,3,1,4,0.0689655172413793,0.75,0.0517241379310344,0,-1
594985,Ben Rowen,2021,AAA,19,16,16,35,2,0,2,0.0571428571428571,1.0,0.0571428571428571,0,-1
594986,Kyle Ryan,2021,AAA,12,4,11,16,1,0,1,0.0625,1.0,0.0625,0,-1
595001,Josh A. Smith,2021,AAA,14,8,6,22,1,0,1,0.0454545454545454,1.0,0.0454545454545454,0,-1
595191,Jerad Eickhoff,2021,AAA,43,20,16,63,6,1,7,0.1111111111111111,0.8571428571428571,0.0952380952380952,0,-1
595255,Mitch Horacek,2021,AAA,7,4,7,11,2,1,3,0.2727272727272727,0.6666666666666666,0.1818181818181818,0,-1
595263,Mickey Jannis,2021,AAA,35,21,13,56,5,0,5,0.0892857142857142,1.0,0.0892857142857142,0,-1
595345,Steven Okert,2021,AAA,11,4,8,15,1,0,1,0.0666666666666666,1.0,0.0666666666666666,0,-1
595411,Ryan Sherriff,2021,AAA,12,7,13,19,2,0,2,0.1052631578947368,1.0,0.1052631578947368,0,-1
595798,R.J. Alaniz,2021,AAA,29,16,25,45,3,0,3,0.0666666666666666,1.0,0.0666666666666666,0,-1
595881,Tyler Beede,2021,AAA,35,21,14,56,5,0,5,0.0892857142857142,1.0,0.0892857142857142,0,-1
595939,Chris Ellis,2021,AAA,38,14,14,52,4,1,5,0.0961538461538461,0.8,0.0769230769230769,0,-1
595988,Heath Holder,2021,AAA,39,18,27,57,6,0,6,0.1052631578947368,1.0,0.1052631578947368,0,-1
596001,Jakob Junis,2021,AAA,12,3,4,15,0,0,0,0.0,,0.0,0,-1
596027,Dillon Maples,2021,AAA,17,8,14,25,2,1,3,0.12,0.6666666666666666,0.08,0,-1
596035,Reggie McClain,2021,AAA,37,16,28,53,10,0,10,0.1886792452830188,1.0,0.1886792452830188,0,-1
596049,Shawn Morimando,2021,AAA,56,26,18,82,3,2,5,0.0609756097560975,0.6,0.0365853658536585,0,-1
596071,Dillon Peters,2021,AAA,29,11,12,40,3,3,6,0.15,0.5,0.075,0,-1
596074,Bobby Poyner,2021,AAA,7,7,6,14,0,0,0,0.0,,0.0,0,-1
596082,Jake Reed,2021,AAA,22,12,17,34,3,0,3,0.088235294117647,1.0,0.088235294117647,0,-1
596111,Jordan Stephens,2021,AAA,31,20,29,51,2,2,4,0.0784313725490196,0.5,0.0392156862745098,0,-1
596271,Casey Lawrence,2021,AAA,33,18,18,51,5,0,5,0.0980392156862745,1.0,0.0980392156862745,0,-1
597113,DJ Johnson,2021,AAA,14,9,10,23,2,0,2,0.0869565217391304,1.0,0.0869565217391304,0,-1
598271,Brian Johnson,2021,AAA,32,16,11,48,6,1,7,0.1458333333333333,0.8571428571428571,0.125,0,-1
598286,Nick Ramirez,2021,AAA,34,17,21,51,2,0,2,0.0392156862745098,1.0,0.0392156862745098,0,-1
600853,Jose Adames,2021,AAA,17,10,13,27,2,2,4,0.1481481481481481,0.5,0.074074074074074,0,-1
600887,Miguel Del Pozo,2021,AAA,15,8,16,23,1,0,1,0.0434782608695652,1.0,0.0434782608695652,0,-1
600921,Andrés Machado,2021,AAA,9,3,7,12,0,0,0,0.0,,0.0,0,-1
600944,David Paulino,2021,AAA,52,22,22,74,3,1,4,0.054054054054054,0.75,0.0405405405405405,0,-1
602929,Markus Solbach,2021,AAA,39,20,14,59,0,0,0,0.0,,0.0,0,-1
605138,Wes Benjamin,2021,AAA,35,23,15,58,3,0,3,0.0517241379310344,1.0,0.0517241379310344,0,-1
605155,Colten Brewer,2021,AAA,8,6,9,14,3,0,3,0.2142857142857142,1.0,0.2142857142857142,0,-1
605194,Jharel Cotton,2021,AAA,24,9,15,33,5,1,6,0.1818181818181818,0.8333333333333334,0.1515151515151515,0,-1
605232,Brandon Finnegan,2021,AAA,50,16,33,66,2,1,3,0.0454545454545454,0.6666666666666666,0.0303030303030303,0,-1
605240,Jace Fry,2021,AAA,18,13,19,31,6,0,6,0.1935483870967742,1.0,0.1935483870967742,0,-1
605254,Daniel Gossett,2021,AAA,65,31,19,96,10,3,13,0.1354166666666666,0.7692307692307693,0.1041666666666666,0,-1
605260,Taylor Guerrieri,2021,AAA,28,20,19,48,6,1,7,0.1458333333333333,0.8571428571428571,0.125,0,-1
605276,David Hess,2021,AAA,27,8,13,35,5,0,5,0.1428571428571428,1.0,0.1428571428571428,0,-1
605301,Williams Jerez,2021,AAA,19,11,13,30,3,0,3,0.1,1.0,0.1,0,-1
605335,Brandon Leibrandt,2021,AAA,35,16,13,51,5,3,8,0.1568627450980392,0.625,0.0980392156862745,0,-1
605338,Jacob Lindgren,2021,AAA,10,7,7,17,0,0,0,0.0,,0.0,0,-1
605388,Adam Morgan,2021,AAA,9,1,6,10,1,0,1,0.1,1.0,0.1,0,-1
605441,Yacksel Ríos,2021,AAA,11,10,9,21,0,0,0,0.0,,0.0,0,-1
605446,Dereck Rodríguez,2021,AAA,57,29,21,86,9,2,11,0.127906976744186,0.8181818181818182,0.1046511627906976,0,-1
605448,Bradley Roney,2021,AAA,21,19,17,40,4,1,5,0.125,0.8,0.1,0,-1
605469,Chandler Shepherd,2021,AAA,76,37,23,113,3,1,4,0.0353982300884955,0.75,0.0265486725663716,0,-1
605501,Stephen Tarpley,2021,AAA,12,9,7,21,1,0,1,0.0476190476190476,1.0,0.0476190476190476,0,-1
605507,Zach Thompson,2021,AAA,9,4,7,13,0,1,1,0.0769230769230769,0.0,0.0,0,-1
605521,Art Warren,2021,AAA,13,4,11,17,1,1,2,0.1176470588235294,0.5,0.0588235294117647,0,-1
605541,Mike Wright Jr.,2021,AAA,40,23,15,63,5,0,5,0.0793650793650793,1.0,0.0793650793650793,0,-1
606162,Yefry Ramírez,2021,AAA,80,36,25,116,15,4,19,0.1637931034482758,0.7894736842105263,0.1293103448275862,0,-1
606208,Luis Lugo,2021,AAA,25,12,8,37,3,1,4,0.1081081081081081,0.75,0.081081081081081,0,-1
606303,Joel Payamps,2021,AAA,9,6,8,15,0,1,1,0.0666666666666666,0.0,0.0,0,-1
606625,Reyes Moronta,2021,AAA,18,13,16,31,1,0,1,0.032258064516129,1.0,0.032258064516129,0,-1
606939,Aaron Brown,2021,AAA,18,16,16,34,0,2,2,0.0588235294117647,0.0,0.0,0,-1
606944,Cody Carroll,2021,AAA,19,7,15,26,2,1,3,0.1153846153846153,0.6666666666666666,0.0769230769230769,0,-1
606981,Darin Gillies,2021,AAA,8,4,8,12,0,0,0,0.0,,0.0,0,-1
606996,Kyle Hart,2021,AAA,62,29,21,91,4,1,5,0.0549450549450549,0.8,0.0439560439560439,0,-1
607067,Colin Rea,2021,AAA,18,6,7,24,2,2,4,0.1666666666666666,0.5,0.0833333333333333,0,-1
607179,Jordan Weems,2021,AAA,14,12,20,26,1,0,1,0.0384615384615384,1.0,0.0384615384615384,0,-1
607188,Jake Faria,2021,AAA,19,13,7,32,3,0,3,0.09375,1.0,0.09375,0,-1
607216,Joey Krehbiel,2021,AAA,28,9,25,37,3,0,3,0.081081081081081,1.0,0.081081081081081,0,-1
607219,Sal Romano,2021,AAA,36,11,18,47,2,0,2,0.0425531914893617,1.0,0.0425531914893617,0,-1
607352,Joe Biagini,2021,AAA,74,32,21,106,26,2,28,0.2641509433962264,0.9285714285714286,0.2452830188679245,0,-1
607374,Nick Tropeano,2021,AAA,28,10,16,38,3,1,4,0.1052631578947368,0.75,0.0789473684210526,0,-1
607391,Chris Mazza,2021,AAA,25,5,15,30,4,1,5,0.1666666666666666,0.8,0.1333333333333333,0,-1
607455,Anthony Banda,2021,AAA,38,21,13,59,3,0,3,0.0508474576271186,1.0,0.0508474576271186,0,-1
607457,Kyle Barraclough,2021,AAA,19,9,20,28,4,2,6,0.2142857142857142,0.6666666666666666,0.1428571428571428,0,-1
607473,Chasen Bradford,2021,AAA,30,13,23,43,7,0,7,0.1627906976744186,1.0,0.1627906976744186,0,-1
607560,Ryne Harper,2021,AAA,8,9,9,17,5,1,6,0.3529411764705882,0.8333333333333334,0.2941176470588235,0,-1
607608,David Kubiak,2021,AAA,20,5,6,25,2,0,2,0.08,1.0,0.08,0,-1
607751,Matt Tomshaw,2021,AAA,13,11,10,24,2,0,2,0.0833333333333333,1.0,0.0833333333333333,0,-1
607755,Andrew Vasquez,2021,AAA,30,15,26,45,9,0,9,0.2,1.0,0.2,0,-1
608328,Chase De Jong,2021,AAA,9,4,4,13,0,0,0,0.0,,0.0,0,-1
608334,Carson Fulmer,2021,AAA,19,19,22,38,1,0,1,0.0263157894736842,1.0,0.0263157894736842,0,-1
608650,Dietrich Enns,2021,AAA,23,13,15,36,2,1,3,0.0833333333333333,0.6666666666666666,0.0555555555555555,0,-1
608691,Mason Melotakis,2021,AAA,22,15,16,37,1,1,2,0.054054054054054,0.5,0.027027027027027,0,-1
611093,Silvino Bracho,2021,AAA,28,14,27,42,4,0,4,0.0952380952380952,1.0,0.0952380952380952,0,-1
612792,Jesús Castillo,2021,AAA,7,7,6,14,2,0,2,0.1428571428571428,1.0,0.1428571428571428,0,-1
615695,Ryan Kellogg,2021,AAA,26,14,10,40,6,1,7,0.175,0.8571428571428571,0.15,0,-1
620396,Miguel Aguilar,2021,AAA,30,21,24,51,3,0,3,0.0588235294117647,1.0,0.0588235294117647,0,-1
620445,José Mujica,2021,AAA,53,37,21,90,2,1,3,0.0333333333333333,0.6666666666666666,0.0222222222222222,0,-1
620982,Ricardo Pinto,2021,AAA,64,32,18,96,3,1,4,0.0416666666666666,0.75,0.03125,0,-1
621051,Steven Wilson,2021,AAA,14,7,15,21,2,0,2,0.0952380952380952,1.0,0.0952380952380952,0,-1
621057,Justin Garza,2021,AAA,9,2,6,11,0,0,0,0.0,,0.0,0,-1
621068,Riley Ferrell,2021,AAA,33,13,24,46,8,0,8,0.1739130434782608,1.0,0.1739130434782608,0,-1
621074,Michael Rucker,2021,AAA,25,12,16,37,4,0,4,0.1081081081081081,1.0,0.1081081081081081,0,-1
621078,Brady Lail,2021,AAA,36,17,26,53,10,0,10,0.1886792452830188,1.0,0.1886792452830188,0,-1
621079,Collin Wiles,2021,AAA,50,23,18,73,4,2,6,0.0821917808219178,0.6666666666666666,0.0547945205479452,0,-1
621082,Jacob Lemoine,2021,AAA,36,14,30,50,2,0,2,0.04,1.0,0.04,0,-1
621086,James Marvel,2021,AAA,89,46,25,135,7,1,8,0.0592592592592592,0.875,0.0518518518518518,0,-1
621088,Bryan Bonnell,2021,AAA,46,17,28,63,2,0,2,0.0317460317460317,1.0,0.0317460317460317,0,-1
621089,José Mesa Jr.,2021,AAA,9,3,4,12,0,0,0,0.0,,0.0,0,-1
621097,Jacob Waguespack,2021,AAA,46,15,18,61,7,0,7,0.1147540983606557,1.0,0.1147540983606557,0,-1
621098,Eric Hanhold,2021,AAA,27,14,18,41,4,0,4,0.0975609756097561,1.0,0.0975609756097561,0,-1
621112,Paul Blackburn,2021,AAA,67,36,17,103,7,1,8,0.0776699029126213,0.875,0.0679611650485436,0,-1
621114,Ryan Burr,2021,AAA,9,3,6,12,1,0,1,0.0833333333333333,1.0,0.0833333333333333,0,-1
621139,Brooks Kriske,2021,AAA,10,10,10,20,3,1,4,0.2,0.75,0.15,0,-1
621143,Jackson McClelland,2021,AAA,19,14,15,33,2,1,3,0.0909090909090909,0.6666666666666666,0.0606060606060606,0,-1
621169,Tyler Eppler,2021,AAA,51,31,19,82,6,2,8,0.0975609756097561,0.75,0.073170731707317,0,-1
621219,Alec Mills,2021,AAA,3,9,3,12,3,0,3,0.25,1.0,0.25,0,-1
621248,Ralph Garza Jr.,2021,AAA,6,4,6,10,2,0,2,0.2,1.0,0.2,0,-1
621259,Brody Koerner,2021,AAA,51,16,20,67,2,0,2,0.0298507462686567,1.0,0.0298507462686567,0,-1
621261,Corey Oswalt,2021,AAA,8,2,5,10,0,0,0,0.0,,0.0,0,-1
621289,Jaime Schultz,2021,AAA,5,5,4,10,2,0,2,0.2,1.0,0.2,0,-1
621290,Dakota Bacus,2021,AAA,32,15,25,47,4,1,5,0.1063829787234042,0.8,0.0851063829787234,0,-1
621366,Ryan Borucki,2021,AAA,8,5,6,13,0,0,0,0.0,,0.0,0,-1
621383,Tanner Banks,2021,AAA,37,19,22,56,5,2,7,0.125,0.7142857142857143,0.0892857142857142,0,-1
621404,Ryan Lawlor,2021,AAA,14,9,9,23,0,0,0,0.0,,0.0,0,-1
622063,Jack Wynkoop,2021,AAA,19,9,7,28,1,3,4,0.1428571428571428,0.25,0.0357142857142857,0,-1
622065,Alex Young,2021,AAA,9,5,7,14,0,0,0,0.0,,0.0,0,-1
622066,Tyler Alexander,2021,AAA,13,11,8,24,0,0,0,0.0,,0.0,0,-1
622230,Andrew Lee,2021,AAA,8,4,4,12,5,1,6,0.5,0.8333333333333334,0.4166666666666667,0,-1
622246,Bubba Derby,2021,AAA,12,9,10,21,2,0,2,0.0952380952380952,1.0,0.0952380952380952,0,-1
622256,Patrick Weigel,2021,AAA,38,26,26,64,8,0,8,0.125,1.0,0.125,0,-1
622338,Jesús Liranzo,2021,AAA,9,1,7,10,1,1,2,0.2,0.5,0.1,0,-1
622353,Ramon Santos,2021,AAA,7,5,3,12,2,0,2,0.1666666666666666,1.0,0.1666666666666666,0,-1
622379,Luis F. Castillo,2021,AAA,21,12,15,33,1,0,1,0.0303030303030303,1.0,0.0303030303030303,0,-1
622446,Jefry Rodriguez,2021,AAA,27,18,11,45,8,1,9,0.2,0.8888888888888888,0.1777777777777777,0,-1
622490,Robinson Leyer,2021,AAA,24,22,24,46,5,1,6,0.1304347826086956,0.8333333333333334,0.108695652173913,0,-1
622492,Keury Mella,2021,AAA,33,12,21,45,7,1,8,0.1777777777777777,0.875,0.1555555555555555,0,-1
622554,Seranthony Domínguez,2021,AAA,17,7,9,24,1,0,1,0.0416666666666666,1.0,0.0416666666666666,0,-1
622766,Miguel Díaz,2021,AAA,13,6,11,19,5,0,5,0.2631578947368421,1.0,0.2631578947368421,0,-1
622786,Jesus Tinoco,2021,AAA,40,24,26,64,5,0,5,0.078125,1.0,0.078125,0,-1
622797,Pedro Payano,2021,AAA,62,24,19,86,4,3,7,0.0813953488372093,0.5714285714285714,0.0465116279069767,0,-1
623354,Daniel Zamora,2021,AAA,34,20,25,54,2,1,3,0.0555555555555555,0.6666666666666666,0.037037037037037,0,-1
623364,Brad Wieck,2021,AAA,6,5,5,11,2,0,2,0.1818181818181818,1.0,0.1818181818181818,0,-1
623381,Thomas Pannone,2021,AAA,71,39,24,110,3,0,3,0.0272727272727272,1.0,0.0272727272727272,0,-1
623402,Tim Peterson,2021,AAA,23,14,23,37,1,0,1,0.027027027027027,1.0,0.027027027027027,0,-1
623430,Ryan Dull,2021,AAA,16,6,13,22,0,0,0,0.0,,0.0,0,-1
623434,Mike Hauschild,2021,AAA,31,18,12,49,3,0,3,0.0612244897959183,1.0,0.0612244897959183,0,-1
623437,Justin Topa,2021,AAA,6,6,3,12,0,0,0,0.0,,0.0,0,-1
623454,Drew Anderson,2021,AAA,28,15,14,43,7,2,9,0.2093023255813953,0.7777777777777778,0.1627906976744186,0,-1
623465,Evan Phillips,2021,AAA,16,10,16,26,2,2,4,0.1538461538461538,0.5,0.0769230769230769,0,-1
623470,Jake Newberry,2021,AAA,37,20,32,57,1,0,1,0.0175438596491228,1.0,0.0175438596491228,0,-1
623474,Jimmy Herget,2021,AAA,25,10,19,35,5,0,5,0.1428571428571428,1.0,0.1428571428571428,0,-1
623485,Ashton Goudeau,2021,AAA,24,9,9,33,2,0,2,0.0606060606060606,1.0,0.0606060606060606,0,-1
624418,Ryan Castellani,2021,AAA,77,34,23,111,15,2,17,0.1531531531531531,0.8823529411764706,0.1351351351351351,0,-1
624420,Ian Clarkin,2021,AAA,40,29,15,69,5,1,6,0.0869565217391304,0.8333333333333334,0.072463768115942,0,-1
624427,Stephen Gonsalves,2021,AAA,59,25,18,84,10,5,15,0.1785714285714285,0.6666666666666666,0.119047619047619,0,-1
624519,Logan Shore,2021,AAA,37,18,14,55,1,3,4,0.0727272727272727,0.25,0.0181818181818181,0,-1
624526,Garrett Williams,2021,AAA,37,18,24,55,6,1,7,0.1272727272727272,0.8571428571428571,0.109090909090909,0,-1
624586,James Hoyt,2021,AAA,29,16,21,45,3,0,3,0.0666666666666666,1.0,0.0666666666666666,0,-1
625643,Reynaldo López,2021,AAA,28,20,10,48,8,1,9,0.1875,0.8888888888888888,0.1666666666666666,0,-1
626929,Lewis Thorpe,2021,AAA,12,2,6,14,0,0,0,0.0,,0.0,0,-1
628345,Darien Núñez,2021,AAA,22,11,20,33,4,0,4,0.1212121212121212,1.0,0.1212121212121212,0,-1
628708,Yunior Marte,2021,AAA,41,22,31,63,4,1,5,0.0793650793650793,0.8,0.0634920634920634,0,-1
628709,Ofreidy Gómez,2021,AAA,17,11,11,28,0,0,0,0.0,,0.0,0,-1
639238,Edgar Arredondo,2021,AAA,20,14,12,34,0,0,0,0.0,,0.0,0,-1
639373,Gerson Bautista,2021,AAA,7,7,6,14,0,0,0,0.0,,0.0,0,-1
640451,Hunter Harvey,2021,AAA,8,3,6,11,0,0,0,0.0,,0.0,0,-1
640453,Connor Jones,2021,AAA,64,32,36,96,9,2,11,0.1145833333333333,0.8181818181818182,0.09375,0,-1
640454,Matt Krook,2021,AAA,60,30,17,90,7,3,10,0.1111111111111111,0.7,0.0777777777777777,0,-1
640462,A.J. Puk,2021,AAA,30,17,22,47,2,1,3,0.0638297872340425,0.6666666666666666,0.0425531914893617,0,-1
640463,Braden Shipley,2021,AAA,14,15,13,29,3,0,3,0.1034482758620689,1.0,0.1034482758620689,0,-1
640464,Kohl Stewart,2021,AAA,11,4,4,15,1,0,1,0.0666666666666666,1.0,0.0666666666666666,0,-1
641312,Shaun Anderson,2021,AAA,16,5,11,21,0,0,0,0.0,,0.0,0,-1
641329,Bryan Baker,2021,AAA,15,8,14,23,3,0,3,0.1304347826086956,1.0,0.1304347826086956,0,-1
641341,Tyler Bashlor,2021,AAA,18,16,23,34,4,0,4,0.1176470588235294,1.0,0.1176470588235294,0,-1
641384,Akeem Bostick,2021,AAA,45,22,14,67,14,3,17,0.2537313432835821,0.8235294117647058,0.208955223880597,0,-1
641420,Zack Burdi,2021,AAA,19,10,15,29,4,0,4,0.1379310344827586,1.0,0.1379310344827586,0,-1
641425,Thomas Burrows,2021,AAA,25,15,21,40,2,1,3,0.075,0.6666666666666666,0.05,0,-1
641438,Shane Carle,2021,AAA,19,14,15,33,1,1,2,0.0606060606060606,0.5,0.0303030303030303,0,-1
641447,Daniel Castano,2021,AAA,43,15,14,58,1,2,3,0.0517241379310344,0.3333333333333333,0.0172413793103448,0,-1
641464,Trey Cobb,2021,AAA,39,21,22,60,0,0,0,0.0,,0.0,0,-1
641501,Tyler Danish,2021,AAA,33,22,21,55,3,0,3,0.0545454545454545,1.0,0.0545454545454545,0,-1
641506,Adrian De Horta,2021,AAA,15,4,8,19,2,2,4,0.2105263157894736,0.5,0.1052631578947368,0,-1
641538,Frank Duncan,2021,AAA,50,17,16,67,5,3,8,0.1194029850746268,0.625,0.0746268656716417,0,-1
641571,Heath Fillmyer,2021,AAA,60,25,18,85,8,0,8,0.0941176470588235,1.0,0.0941176470588235,0,-1
641576,Bernardo Flores Jr.,2021,AAA,28,13,11,41,0,3,3,0.073170731707317,0.0,0.0,0,-1
641585,J.P. France,2021,AAA,34,18,16,52,5,0,5,0.0961538461538461,1.0,0.0961538461538461,0,-1
641620,Brandon Gold,2021,AAA,54,28,18,82,4,4,8,0.0975609756097561,0.5,0.048780487804878,0,-1
641627,Trevor Gott,2021,AAA,23,14,22,37,3,0,3,0.081081081081081,1.0,0.081081081081081,0,-1
641632,Conner Greene,2021,AAA,26,8,9,34,2,0,2,0.0588235294117647,1.0,0.0588235294117647,0,-1
641656,Ian Hamilton,2021,AAA,47,23,31,70,3,0,3,0.0428571428571428,1.0,0.0428571428571428,0,-1
641672,Thomas Hatch,2021,AAA,36,15,14,51,2,1,3,0.0588235294117647,0.6666666666666666,0.0392156862745098,0,-1
641682,Ryan Hendrix,2021,AAA,11,6,8,17,0,0,0,0.0,,0.0,0,-1
641703,Brent Honeywell,2021,AAA,40,26,20,66,7,2,9,0.1363636363636363,0.7777777777777778,0.106060606060606,0,-1
641709,Brian Howard,2021,AAA,61,39,24,100,10,1,11,0.11,0.9090909090909092,0.1,0,-1
641726,Daulton Jefferies,2021,AAA,37,20,14,57,3,1,4,0.0701754385964912,0.75,0.0526315789473684,0,-1
641733,Connor Johnstone,2021,AAA,36,24,20,60,1,0,1,0.0166666666666666,1.0,0.0166666666666666,0,-1
641743,Anthony Kay,2021,AAA,17,16,7,33,5,0,5,0.1515151515151515,1.0,0.1515151515151515,0,-1
641838,Kevin McCarthy,2021,AAA,30,17,20,47,0,2,2,0.0425531914893617,0.0,0.0,0,-1
641855,Ian McKinney,2021,AAA,33,16,11,49,5,0,5,0.1020408163265306,1.0,0.1020408163265306,0,-1
641886,Andrew Mitchell,2021,AAA,7,5,4,12,1,0,1,0.0833333333333333,1.0,0.0833333333333333,0,-1
641899,Ryan Moseley,2021,AAA,54,26,34,80,2,1,3,0.0375,0.6666666666666666,0.025,0,-1
641900,Scott Moss,2021,AAA,16,5,8,21,3,0,3,0.1428571428571428,1.0,0.1428571428571428,0,-1
641907,Patrick Murphy,2021,AAA,8,4,9,12,0,2,2,0.1666666666666666,0.0,0.0,0,-1
641927,Bailey Ober,2021,AAA,7,8,4,15,3,0,3,0.2,1.0,0.2,0,-1
641949,John Parke,2021,AAA,33,11,10,44,4,1,5,0.1136363636363636,0.8,0.0909090909090909,0,-1
641988,Alex Powers,2021,AAA,32,13,24,45,8,1,9,0.2,0.8888888888888888,0.1777777777777777,0,-1
641995,Roel Ramírez,2021,AAA,39,22,28,61,3,0,3,0.0491803278688524,1.0,0.0491803278688524,0,-1
642028,Josh Rogers,2021,AAA,63,19,17,82,1,2,3,0.0365853658536585,0.3333333333333333,0.0121951219512195,0,-1
642041,Zac Ryan,2021,AAA,24,17,18,41,1,0,1,0.024390243902439,1.0,0.024390243902439,0,-1
642048,Tayler Saucedo,2021,AAA,11,2,8,13,1,0,1,0.0769230769230769,1.0,0.0769230769230769,0,-1
642060,Cody Sedlock,2021,AAA,19,8,7,27,0,2,2,0.074074074074074,0.0,0.0,0,-1
642067,Mike Shawaryn,2021,AAA,14,5,8,19,1,0,1,0.0526315789473684,1.0,0.0526315789473684,0,-1
642083,Aaron Slegers,2021,AAA,27,13,12,40,3,0,3,0.075,1.0,0.075,0,-1
642092,Riley Smith,2021,AAA,9,4,4,13,2,0,2,0.1538461538461538,1.0,0.1538461538461538,0,-1
642100,Gabe Speier,2021,AAA,33,16,27,49,2,1,3,0.0612244897959183,0.6666666666666666,0.0408163265306122,0,-1
642231,Jimmy Yacabonis,2021,AAA,21,6,18,27,1,0,1,0.037037037037037,1.0,0.037037037037037,0,-1
642233,Eric Yardley,2021,AAA,22,18,21,40,4,0,4,0.1,1.0,0.1,0,-1
642239,Rob Zastryzny,2021,AAA,21,7,17,28,1,0,1,0.0357142857142857,1.0,0.0357142857142857,0,-1
642371,Junior Garcia,2021,AAA,31,12,22,43,1,0,1,0.0232558139534883,1.0,0.0232558139534883,0,-1
642508,Jesus Zambrano,2021,AAA,9,7,7,16,0,0,0,0.0,,0.0,0,-1
642520,Gerson Garabito,2021,AAA,34,9,11,43,2,1,3,0.0697674418604651,0.6666666666666666,0.0465116279069767,0,-1
642530,Luis Reyes,2021,AAA,34,24,9,58,5,0,5,0.0862068965517241,1.0,0.0862068965517241,0,-1
642545,Jaime Barria,2021,AAA,25,11,9,36,1,0,1,0.0277777777777777,1.0,0.0277777777777777,0,-1
642564,Francis Martes,2021,AAA,10,10,8,20,0,0,0,0.0,,0.0,0,-1
642565,Alexander Guillen,2021,AAA,20,7,11,27,2,0,2,0.074074074074074,1.0,0.074074074074074,0,-1
642578,José Rodríguez,2021,AAA,43,32,17,75,0,1,1,0.0133333333333333,0.0,0.0,0,-1
642584,Franklyn Kilome,2021,AAA,31,15,15,46,9,2,11,0.2391304347826087,0.8181818181818182,0.1956521739130435,0,-1
642585,Félix Bautista,2021,AAA,8,12,9,20,2,0,2,0.1,1.0,0.1,0,-1
642601,Oscar De La Cruz,2021,AAA,8,8,4,16,0,0,0,0.0,,0.0,0,-1
642609,Joan Baez,2021,AAA,15,5,7,20,2,1,3,0.15,0.6666666666666666,0.1,0,-1
642659,Raynel Espinal,2021,AAA,66,27,22,93,13,2,15,0.1612903225806451,0.8666666666666667,0.1397849462365591,0,-1
642758,Domingo Acevedo,2021,AAA,10,6,11,16,0,0,0,0.0,,0.0,0,-1
642759,Julian Fernández,2021,AAA,11,1,8,12,1,2,3,0.25,0.3333333333333333,0.0833333333333333,0,-1
642834,Jonathan Bermúdez,2021,AAA,10,6,6,16,2,0,2,0.125,1.0,0.125,0,-1
642840,Joe Harvey,2021,AAA,15,3,13,18,2,0,2,0.1111111111111111,1.0,0.1111111111111111,0,-1
643239,Parker Bugg,2021,AAA,34,31,28,65,6,1,7,0.1076923076923077,0.8571428571428571,0.0923076923076923,0,-1
643316,Paul Fry,2021,AAA,12,3,7,15,1,0,1,0.0666666666666666,1.0,0.0666666666666666,0,-1
643327,Zack Godley,2021,AAA,89,35,20,124,5,1,6,0.0483870967741935,0.8333333333333334,0.0403225806451612,0,-1
643340,Nick Green,2021,AAA,52,21,21,73,5,0,5,0.0684931506849315,1.0,0.0684931506849315,0,-1
643361,Kevin Herget,2021,AAA,38,20,22,58,3,4,7,0.1206896551724138,0.4285714285714285,0.0517241379310344,0,-1
643377,Griffin Jax,2021,AAA,25,16,7,41,5,1,6,0.1463414634146341,0.8333333333333334,0.1219512195121951,0,-1
643400,Dusten Knight,2021,AAA,16,7,17,23,1,0,1,0.0434782608695652,1.0,0.0434782608695652,0,-1
643410,Mark Leiter Jr.,2021,AAA,45,27,16,72,11,1,12,0.1666666666666666,0.9166666666666666,0.1527777777777778,0,-1
643478,Joe Palumbo,2021,AAA,8,5,6,13,1,1,2,0.1538461538461538,0.5,0.0769230769230769,0,-1
643493,Austin Pruitt,2021,AAA,6,6,8,12,2,0,2,0.1666666666666666,1.0,0.1666666666666666,0,-1
643532,Sterling Sharp,2021,AAA,67,32,16,99,9,0,9,0.0909090909090909,1.0,0.0909090909090909,0,-1
643539,Caleb Simpson,2021,AAA,9,6,7,15,2,0,2,0.1333333333333333,1.0,0.1333333333333333,0,-1
643615,T.J. Zeuch,2021,AAA,73,35,20,108,13,2,15,0.1388888888888889,0.8666666666666667,0.1203703703703703,0,-1
643778,Tyler Webb,2021,AAA,16,4,13,20,0,0,0,0.0,,0.0,0,-1
644364,Víctor Arano,2021,AAA,21,9,17,30,1,2,3,0.1,0.3333333333333333,0.0333333333333333,0,-1
644429,Anderson Severino,2021,AAA,5,5,7,10,0,0,0,0.0,,0.0,0,-1
646242,Jhonathan Díaz,2021,AAA,12,8,3,20,1,0,1,0.05,1.0,0.05,0,-1
647306,Ben Onyshko,2021,AAA,8,2,6,10,0,0,0,0.0,,0.0,0,-1
649144,Alex Wells,2021,AAA,24,12,11,36,2,3,5,0.1388888888888889,0.4,0.0555555555555555,0,-1
649963,Bo Takahashi,2021,AAA,55,19,18,74,3,0,3,0.0405405405405405,1.0,0.0405405405405405,0,-1
650347,Luís Madero,2021,AAA,32,15,14,47,9,1,10,0.2127659574468085,0.9,0.1914893617021276,0,-1
650378,Ofelky Peralta,2021,AAA,40,10,10,50,2,1,3,0.06,0.6666666666666666,0.04,0,-1
650493,Henry Martinez,2021,AAA,13,6,11,19,1,0,1,0.0526315789473684,1.0,0.0526315789473684,0,-1
650496,J.C. Mejía,2021,AAA,15,6,7,21,1,0,1,0.0476190476190476,1.0,0.0476190476190476,0,-1
650530,Bryan Garcia,2021,AAA,15,8,12,23,1,0,1,0.0434782608695652,1.0,0.0434782608695652,0,-1
650556,Bryan Abreu,2021,AAA,10,4,8,14,0,1,1,0.0714285714285714,0.0,0.0,0,-1
650668,Humberto Mejía,2021,AAA,49,23,15,72,1,0,1,0.0138888888888888,1.0,0.0138888888888888,0,-1
650671,José Quijada,2021,AAA,14,6,12,20,0,0,0,0.0,,0.0,0,-1
650841,Diomar Lopez,2021,AAA,9,4,7,13,1,0,1,0.0769230769230769,1.0,0.0769230769230769,0,-1
650911,Cristopher Sánchez,2021,AAA,54,27,18,81,12,1,13,0.1604938271604938,0.9230769230769232,0.1481481481481481,0,-1
650959,Marcos Diplán,2021,AAA,11,7,12,18,0,0,0,0.0,,0.0,0,-1
651002,Steven Fuentes,2021,AAA,22,15,7,37,4,0,4,0.1081081081081081,1.0,0.1081081081081081,0,-1
656001,Moises Gomez,2021,AAA,8,7,6,15,2,1,3,0.2,0.6666666666666666,0.1333333333333333,0,-1
656004,Carlos Sanabria,2021,AAA,21,16,14,37,1,2,3,0.081081081081081,0.3333333333333333,0.027027027027027,0,-1
656032,Daniel Álvarez,2021,AAA,11,7,8,18,0,0,0,0.0,,0.0,0,-1
656061,Albert Abreu,2021,AAA,7,7,6,14,3,0,3,0.2142857142857142,1.0,0.2142857142857142,0,-1
656077,Félix Paulino,2021,AAA,14,9,5,23,4,1,5,0.217391304347826,0.8,0.1739130434782608,0,-1
656080,Aneuris Rosario,2021,AAA,11,3,6,14,3,0,3,0.2142857142857142,1.0,0.2142857142857142,0,-1
656196,Argenis Angulo,2021,AAA,34,15,27,49,2,0,2,0.0408163265306122,1.0,0.0408163265306122,0,-1
656210,Brandon Barker,2021,AAA,45,21,14,66,4,2,6,0.0909090909090909,0.6666666666666666,0.0606060606060606,0,-1
656212,Charlie Barnes,2021,AAA,46,21,15,67,4,0,4,0.0597014925373134,1.0,0.0597014925373134,0,-1
656232,Brandon Bielak,2021,AAA,13,4,5,17,1,0,1,0.0588235294117647,1.0,0.0588235294117647,0,-1
656234,Jake Bird,2021,AAA,29,15,19,44,2,2,4,0.0909090909090909,0.5,0.0454545454545454,0,-1
656240,Scott Blewett,2021,AAA,55,21,18,76,6,0,6,0.0789473684210526,1.0,0.0789473684210526,0,-1
656271,Brock Burke,2021,AAA,45,31,21,76,7,2,9,0.1184210526315789,0.7777777777777778,0.0921052631578947,0,-1
656290,Drew Carlton,2021,AAA,28,18,20,46,1,1,2,0.0434782608695652,0.5,0.0217391304347826,0,-1
656342,Keegan Curtis,2021,AAA,5,5,6,10,1,1,2,0.2,0.5,0.1,0,-1
656354,Austin Davis,2021,AAA,6,4,5,10,1,1,2,0.2,0.5,0.1,0,-1
656416,Brady Feigl,2021,AAA,11,8,5,19,0,1,1,0.0526315789473684,0.0,0.0,0,-1
656450,Joe Gatto,2021,AAA,24,12,17,36,10,0,10,0.2777777777777778,1.0,0.2777777777777778,0,-1
656457,Tyler Gilbert,2021,AAA,24,18,11,42,4,2,6,0.1428571428571428,0.6666666666666666,0.0952380952380952,0,-1
656492,Foster Griffin,2021,AAA,23,11,6,34,4,0,4,0.1176470588235294,1.0,0.1176470588235294,0,-1
656544,Colton Hock,2021,AAA,7,8,6,15,0,0,0,0.0,,0.0,0,-1
656548,Jordan Holloway,2021,AAA,32,11,7,43,14,0,14,0.3255813953488372,1.0,0.3255813953488372,0,-1
656550,Grant Holmes,2021,AAA,58,33,33,91,2,2,4,0.0439560439560439,0.5,0.0219780219780219,0,-1
656557,Tanner Houck,2021,AAA,11,8,5,19,1,0,1,0.0526315789473684,1.0,0.0526315789473684,0,-1
656561,Nick Howard,2021,AAA,21,9,14,30,1,0,1,0.0333333333333333,1.0,0.0333333333333333,0,-1
656578,Andre Jackson,2021,AAA,16,6,6,22,1,0,1,0.0454545454545454,1.0,0.0454545454545454,0,-1
656592,Tyler Johnson,2021,AAA,13,11,13,24,3,0,3,0.125,1.0,0.125,0,-1
656594,Kyle Johnston,2021,AAA,8,2,6,10,1,0,1,0.1,1.0,0.1,0,-1
656605,Mitch Keller,2021,AAA,17,15,7,32,8,2,10,0.3125,0.8,0.25,0,-1
656620,Gabe Klobosits,2021,AAA,11,10,10,21,2,0,2,0.0952380952380952,1.0,0.0952380952380952,0,-1
656638,Alex Lange,2021,AAA,23,13,13,36,5,1,6,0.1666666666666666,0.8333333333333334,0.1388888888888889,0,-1
656641,Jacob Latz,2021,AAA,18,11,7,29,3,0,3,0.1034482758620689,1.0,0.1034482758620689,0,-1
656657,Zach Logue,2021,AAA,44,21,18,65,5,2,7,0.1076923076923077,0.7142857142857143,0.0769230769230769,0,-1
656671,Josh Maciejewski,2021,AAA,10,10,4,20,0,1,1,0.05,0.0,0.0,0,-1
656686,Corbin Martin,2021,AAA,20,12,6,32,0,0,0,0.0,,0.0,0,-1
656701,Kade McClure,2021,AAA,26,15,9,41,5,1,6,0.1463414634146341,0.8333333333333334,0.1219512195121951,0,-1
656725,Alex McRae,2021,AAA,67,41,24,108,16,0,16,0.1481481481481481,1.0,0.1481481481481481,0,-1
656726,Sam McWilliams,2021,AAA,31,25,22,56,5,0,5,0.0892857142857142,1.0,0.0892857142857142,0,-1
656727,Kodi Medeiros,2021,AAA,23,12,18,35,5,0,5,0.1428571428571428,1.0,0.1428571428571428,0,-1
656730,Trevor Megill,2021,AAA,9,3,6,12,1,0,1,0.0833333333333333,1.0,0.0833333333333333,0,-1
656731,Tylor Megill,2021,AAA,10,4,3,14,0,1,1,0.0714285714285714,0.0,0.0,0,-1
656793,Nick Nelson,2021,AAA,46,23,25,69,13,0,13,0.1884057971014492,1.0,0.1884057971014492,0,-1
656794,Sean Newcomb,2021,AAA,6,5,7,11,2,0,2,0.1818181818181818,1.0,0.1818181818181818,0,-1
656803,James Norwood,2021,AAA,25,8,25,33,2,0,2,0.0606060606060606,1.0,0.0606060606060606,0,-1
656804,Andrés Núñez,2021,AAA,15,7,10,22,1,0,1,0.0454545454545454,1.0,0.0454545454545454,0,-1
656814,Luis F. Ortiz,2021,AAA,15,14,16,29,1,1,2,0.0689655172413793,0.5,0.0344827586206896,0,-1
656818,Connor Overton,2021,AAA,29,17,17,46,5,1,6,0.1304347826086956,0.8333333333333334,0.108695652173913,0,-1
656885,James Reeves,2021,AAA,5,5,6,10,0,0,0,0.0,,0.0,0,-1
656889,Jeremy Rhoades,2021,AAA,7,4,8,11,0,0,0,0.0,,0.0,0,-1
656924,Ryder Ryan,2021,AAA,33,20,25,53,7,1,8,0.1509433962264151,0.875,0.1320754716981132,0,-1
656977,Chad Sobotka,2021,AAA,26,13,22,39,3,2,5,0.1282051282051282,0.6,0.0769230769230769,0,-1
656981,Peter Solomon,2021,AAA,57,21,21,78,4,2,6,0.0769230769230769,0.6666666666666666,0.0512820512820512,0,-1
656986,Bennett Sousa,2021,AAA,11,6,10,17,5,0,5,0.2941176470588235,1.0,0.2941176470588235,0,-1
657006,Justin Steele,2021,AAA,11,6,7,17,2,1,3,0.1764705882352941,0.6666666666666666,0.1176470588235294,0,-1
657047,Reagan Todd,2021,AAA,8,5,7,13,0,0,0,0.0,,0.0,0,-1
657053,Touki Toussaint,2021,AAA,12,5,6,17,2,0,2,0.1176470588235294,1.0,0.1176470588235294,0,-1
657093,Spenser Watkins,2021,AAA,16,11,8,27,1,0,1,0.037037037037037,1.0,0.037037037037037,0,-1
657097,Jacob Webb,2021,AAA,8,5,10,13,1,0,1,0.0769230769230769,1.0,0.0769230769230769,0,-1
657101,Nick Wells,2021,AAA,23,14,17,37,0,1,1,0.027027027027027,0.0,0.0,0,-1
657122,Ronnie Williams,2021,AAA,11,5,4,16,2,0,2,0.125,1.0,0.125,0,-1
657140,Kyle Wright,2021,AAA,82,39,24,121,8,1,9,0.0743801652892562,0.8888888888888888,0.0661157024793388,0,-1
657141,Jordan Yamamoto,2021,AAA,13,5,6,18,5,0,5,0.2777777777777778,1.0,0.2777777777777778,0,-1
657203,Will Carter,2021,AAA,26,21,24,47,7,1,8,0.1702127659574468,0.875,0.1489361702127659,0,-1
657228,Jake Jewell,2021,AAA,28,12,23,40,0,0,0,0.0,,0.0,0,-1
657248,Glenn Otto,2021,AAA,15,11,6,26,3,1,4,0.1538461538461538,0.75,0.1153846153846153,0,-1
657272,Erich Uelmen,2021,AAA,14,8,10,22,0,0,0,0.0,,0.0,0,-1
657376,Clarke Schmidt,2021,AAA,15,6,6,21,4,0,4,0.1904761904761904,1.0,0.1904761904761904,0,-1
657424,Matt Gage,2021,AAA,20,9,17,29,2,0,2,0.0689655172413793,1.0,0.0689655172413793,0,-1
657508,Mike Baumann,2021,AAA,17,7,6,24,2,0,2,0.0833333333333333,1.0,0.0833333333333333,0,-1
657518,Matt Blackham,2021,AAA,14,14,16,28,2,0,2,0.0714285714285714,1.0,0.0714285714285714,0,-1
657610,Trevor Hildenberger,2021,AAA,21,8,15,29,5,0,5,0.1724137931034483,1.0,0.1724137931034483,0,-1
657611,Cam Hill,2021,AAA,26,15,16,41,4,1,5,0.1219512195121951,0.8,0.0975609756097561,0,-1
657624,Josh James,2021,AAA,13,6,14,19,3,0,3,0.1578947368421052,1.0,0.1578947368421052,0,-1
657681,Kyle McGrath,2021,AAA,37,26,21,63,6,1,7,0.1111111111111111,0.8571428571428571,0.0952380952380952,0,-1
657697,Vinny Nittoli,2021,AAA,30,12,18,42,11,0,11,0.2619047619047619,1.0,0.2619047619047619,0,-1
657746,Joe Ryan,2021,AAA,20,16,12,36,7,1,8,0.2222222222222222,0.875,0.1944444444444444,0,-1
657756,Connor Seabold,2021,AAA,31,11,10,42,1,1,2,0.0476190476190476,0.5,0.0238095238095238,0,-1
657766,Locke St. John,2021,AAA,41,17,24,58,2,1,3,0.0517241379310344,0.6666666666666666,0.0344827586206896,0,-1
657770,Eric Stout,2021,AAA,19,7,5,26,1,0,1,0.0384615384615384,1.0,0.0384615384615384,0,-1
658305,Edgar García,2021,AAA,26,13,22,39,2,3,5,0.1282051282051282,0.4,0.0512820512820512,0,-1
658431,Adonis Medina,2021,AAA,47,22,13,69,1,0,1,0.0144927536231884,1.0,0.0144927536231884,0,-1
658551,Junior Fernández,2021,AAA,7,4,7,11,1,0,1,0.0909090909090909,1.0,0.0909090909090909,0,-1
658648,Pedro Avila,2021,AAA,21,9,11,30,2,0,2,0.0666666666666666,1.0,0.0666666666666666,0,-1
658792,Aaron Wilkerson,2021,AAA,44,21,22,65,3,1,4,0.0615384615384615,0.75,0.0461538461538461,0,-1
659070,Ben Bracewell,2021,AAA,39,16,33,55,4,1,5,0.0909090909090909,0.8,0.0727272727272727,0,-1
660302,Dalbert Siri,2021,AAA,18,8,12,26,2,0,2,0.0769230769230769,1.0,0.0769230769230769,0,-1
660365,Hyeon-Jong Yang,2021,AAA,21,14,9,35,1,0,1,0.0285714285714285,1.0,0.0285714285714285,0,-1
660422,Jorge Guzmán,2021,AAA,10,5,5,15,2,0,2,0.1333333333333333,1.0,0.1333333333333333,0,-1
660431,Hector Perez,2021,AAA,10,3,7,13,2,0,2,0.1538461538461538,1.0,0.1538461538461538,0,-1
660435,Chester Pimentel,2021,AAA,21,13,16,34,5,0,5,0.1470588235294117,1.0,0.1470588235294117,0,-1
660494,Rogelio Armenteros,2021,AAA,24,13,9,37,3,2,5,0.1351351351351351,0.6,0.081081081081081,0,-1
660508,Norwith Gudiño,2021,AAA,18,15,12,33,2,0,2,0.0606060606060606,1.0,0.0606060606060606,0,-1
660546,Yennsy Díaz,2021,AAA,9,6,8,15,1,0,1,0.0666666666666666,1.0,0.0666666666666666,0,-1
660600,Enoli Paredes,2021,AAA,23,9,17,32,2,0,2,0.0625,1.0,0.0625,0,-1
660623,Huascar Ynoa,2021,AAA,6,5,2,11,1,0,1,0.0909090909090909,1.0,0.0909090909090909,0,-1
660674,Alberto Guerrero,2021,AAA,10,7,10,17,0,0,0,0.0,,0.0,0,-1
660749,Wladimir Pinto,2021,AAA,39,17,27,56,7,0,7,0.125,1.0,0.125,0,-1
660813,Brusdar Graterol,2021,AAA,7,9,7,16,0,0,0,0.0,,0.0,0,-1
660825,Eduard Bazardo,2021,AAA,8,3,7,11,1,0,1,0.0909090909090909,1.0,0.0909090909090909,0,-1
660875,Jesús Reyes,2021,AAA,101,41,25,142,3,3,6,0.0422535211267605,0.5,0.0211267605633802,0,-1
660906,Francisco Pérez,2021,AAA,18,8,16,26,1,1,2,0.0769230769230769,0.5,0.0384615384615384,0,-1
661255,Yoan López,2021,AAA,27,10,18,37,4,0,4,0.1081081081081081,1.0,0.1081081081081081,0,-1
661309,Adrián Martínez,2021,AAA,37,17,9,54,5,2,7,0.1296296296296296,0.7142857142857143,0.0925925925925925,0,-1
661332,Luke Westphal,2021,AAA,29,19,15,48,2,2,4,0.0833333333333333,0.5,0.0416666666666666,0,-1
661383,Oliver Ortega,2021,AAA,7,4,6,11,1,0,1,0.0909090909090909,1.0,0.0909090909090909,0,-1
661395,Jhoan Duran,2021,AAA,15,5,5,20,0,0,0,0.0,,0.0,0,-1
661440,Mauricio Llovera,2021,AAA,29,15,24,44,2,0,2,0.0454545454545454,1.0,0.0454545454545454,0,-1
661527,Seth Martinez,2021,AAA,20,11,20,31,2,0,2,0.064516129032258,1.0,0.064516129032258,0,-1
661563,Luis Gil,2021,AAA,30,12,13,42,0,0,0,0.0,,0.0,0,-1
661832,Danny Dopico,2021,AAA,12,12,14,24,1,0,1,0.0416666666666666,1.0,0.0416666666666666,0,-1
662144,Brian Keller,2021,AAA,38,24,20,62,9,1,10,0.1612903225806451,0.9,0.1451612903225806,0,-1
663325,Kevin Smith,2021,AAA,50,29,16,79,13,3,16,0.2025316455696202,0.8125,0.1645569620253164,0,-1
663366,Beau Burrows,2021,AAA,28,17,20,45,6,0,6,0.1333333333333333,1.0,0.1333333333333333,0,-1
663378,Thomas Szapucki,2021,AAA,38,15,10,53,7,2,9,0.1698113207547169,0.7777777777777778,0.1320754716981132,0,-1
663385,Chad Smith,2021,AAA,25,8,19,33,3,3,6,0.1818181818181818,0.5,0.0909090909090909,0,-1
663390,Ryan Mason,2021,AAA,9,6,8,15,1,0,1,0.0666666666666666,1.0,0.0666666666666666,0,-1
663393,Justin Donatella,2021,AAA,7,8,5,15,2,0,2,0.1333333333333333,1.0,0.1333333333333333,0,-1
663399,Brandon Waddell,2021,AAA,7,5,7,12,2,1,3,0.25,0.6666666666666666,0.1666666666666666,0,-1
663472,Jack Perkins,2021,AAA,13,8,6,21,0,0,0,0.0,,0.0,0,-1
663474,Triston McKenzie,2021,AAA,8,6,5,14,0,0,0,0.0,,0.0,0,-1
663510,Ben Leeper,2021,AAA,10,3,8,13,2,1,3,0.2307692307692307,0.6666666666666666,0.1538461538461538,0,-1
663531,Logan Allen,2021,AAA,34,23,11,57,4,0,4,0.0701754385964912,1.0,0.0701754385964912,0,-1
663546,Sean Hjelle,2021,AAA,39,24,10,63,1,1,2,0.0317460317460317,0.5,0.0158730158730158,0,-1
663558,Jovani Morán,2021,AAA,17,11,12,28,5,0,5,0.1785714285714285,1.0,0.1785714285714285,0,-1
663559,Bailey Falter,2021,AAA,17,2,7,19,1,0,1,0.0526315789473684,1.0,0.0526315789473684,0,-1
663574,Tony Santillan,2021,AAA,16,6,9,22,1,0,1,0.0454545454545454,1.0,0.0454545454545454,0,-1
663587,Fitz Stadler,2021,AAA,11,4,7,15,3,0,3,0.2,1.0,0.2,0,-1
663629,Ethan Small,2021,AAA,29,5,9,34,2,1,3,0.088235294117647,0.6666666666666666,0.0588235294117647,0,-1
663678,Colton Eastman,2021,AAA,11,8,4,19,2,0,2,0.1052631578947368,1.0,0.1052631578947368,0,-1
663734,Nick Neidert,2021,AAA,47,14,14,61,1,2,3,0.0491803278688524,0.3333333333333333,0.0163934426229508,0,-1
663735,Matt Frisbee,2021,AAA,31,21,11,52,0,0,0,0.0,,0.0,0,-1
663738,Daniel Lynch IV,2021,AAA,39,16,12,55,9,0,9,0.1636363636363636,1.0,0.1636363636363636,0,-1
663752,Cody Morris,2021,AAA,18,6,8,24,2,0,2,0.0833333333333333,1.0,0.0833333333333333,0,-1
663753,Reiss Knehr,2021,AAA,15,2,7,17,2,0,2,0.1176470588235294,1.0,0.1176470588235294,0,-1
663765,Jake Woodford,2021,AAA,25,17,7,42,2,1,3,0.0714285714285714,0.6666666666666666,0.0476190476190476,0,-1
663770,Demarcus Evans,2021,AAA,8,7,6,15,0,0,0,0.0,,0.0,0,-1
663804,Jackson Kowar,2021,AAA,46,23,17,69,10,2,12,0.1739130434782608,0.8333333333333334,0.144927536231884,0,-1
663878,Nate Pearson,2021,AAA,19,8,8,27,0,0,0,0.0,,0.0,0,-1
663884,Nolan Kingham,2021,AAA,27,16,7,43,1,0,1,0.0232558139534883,1.0,0.0232558139534883,0,-1
663893,Brendon Little,2021,AAA,10,7,7,17,1,0,1,0.0588235294117647,1.0,0.0588235294117647,0,-1
663910,Jordan Guerrero,2021,AAA,32,15,20,47,2,0,2,0.0425531914893617,1.0,0.0425531914893617,0,-1
663947,Tyler Holton,2021,AAA,11,7,5,18,0,0,0,0.0,,0.0,0,-1
663959,Tyler Ivey,2021,AAA,8,6,4,14,0,0,0,0.0,,0.0,0,-1
663969,Tyler Phillips,2021,AAA,10,6,4,16,1,0,1,0.0625,1.0,0.0625,0,-1
663975,Nick Duron,2021,AAA,16,2,8,18,2,0,2,0.1111111111111111,1.0,0.1111111111111111,0,-1
663982,David Parkinson,2021,AAA,48,44,20,92,2,2,4,0.0434782608695652,0.5,0.0217391304347826,0,-1
663989,Nick Vespi,2021,AAA,14,8,12,22,0,0,0,0.0,,0.0,0,-1
664028,Brett Kennedy,2021,AAA,40,20,11,60,1,0,1,0.0166666666666666,1.0,0.0166666666666666,0,-1
664045,Thomas Eshelman,2021,AAA,18,17,11,35,5,0,5,0.1428571428571428,1.0,0.1428571428571428,0,-1
664069,Ben Braymer,2021,AAA,79,25,24,104,8,2,10,0.0961538461538461,0.8,0.0769230769230769,0,-1
664074,Cody Ponce,2021,AAA,34,9,15,43,2,2,4,0.0930232558139534,0.5,0.0465116279069767,0,-1
664076,Garrett Cleavinger,2021,AAA,8,3,8,11,2,0,2,0.1818181818181818,1.0,0.1818181818181818,0,-1
664092,Sean Poppen,2021,AAA,29,9,17,38,3,1,4,0.1052631578947368,0.75,0.0789473684210526,0,-1
664114,Cole Uvila,2021,AAA,18,18,12,36,2,0,2,0.0555555555555555,1.0,0.0555555555555555,0,-1
664116,Zack Erwin,2021,AAA,12,6,12,18,1,0,1,0.0555555555555555,1.0,0.0555555555555555,0,-1
664123,Scott Effross,2021,AAA,25,7,14,32,2,2,4,0.125,0.5,0.0625,0,-1
664129,Geoff Hartlieb,2021,AAA,24,10,15,34,1,0,1,0.0294117647058823,1.0,0.0294117647058823,0,-1
664139,Ian Gibaut,2021,AAA,31,20,20,51,2,0,2,0.0392156862745098,1.0,0.0392156862745098,0,-1
664144,Jon Olczak,2021,AAA,10,7,7,17,3,0,3,0.1764705882352941,1.0,0.1764705882352941,0,-1
664157,Travis Bergen,2021,AAA,17,7,15,24,0,0,0,0.0,,0.0,0,-1
664158,Matt Eckelman,2021,AAA,42,25,26,67,4,1,5,0.0746268656716417,0.8,0.0597014925373134,0,-1
664161,Matt Swarmer,2021,AAA,45,20,17,65,4,0,4,0.0615384615384615,1.0,0.0615384615384615,0,-1
664180,Matt Hall,2021,AAA,33,20,24,53,5,0,5,0.0943396226415094,1.0,0.0943396226415094,0,-1
664194,Blake Bass,2021,AAA,8,6,5,14,1,0,1,0.0714285714285714,1.0,0.0714285714285714,0,-1
664196,Tanner Anderson,2021,AAA,36,18,22,54,0,0,0,0.0,,0.0,0,-1
664202,Tyler Cyr,2021,AAA,24,12,21,36,0,1,1,0.0277777777777777,0.0,0.0,0,-1
664285,Framber Valdez,2021,AAA,10,3,2,13,1,0,1,0.0769230769230769,1.0,0.0769230769230769,0,-1
664294,Dauri Moreta,2021,AAA,10,3,10,13,0,0,0,0.0,,0.0,0,-1
664337,Miguel Yajure,2021,AAA,27,12,9,39,1,2,3,0.0769230769230769,0.3333333333333333,0.0256410256410256,0,-1
664682,Ryan Meisinger,2021,AAA,25,13,19,38,2,0,2,0.0526315789473684,1.0,0.0526315789473684,0,-1
664687,Durbin Feltman,2021,AAA,7,5,8,12,2,0,2,0.1666666666666666,1.0,0.1666666666666666,0,-1
664785,Tom Hackimer,2021,AAA,18,9,14,27,0,0,0,0.0,,0.0,0,-1
664843,Jerry Keel,2021,AAA,50,29,12,79,4,0,4,0.050632911392405,1.0,0.050632911392405,0,-1
664849,Danny Young,2021,AAA,47,15,31,62,2,0,2,0.032258064516129,1.0,0.032258064516129,0,-1
664851,Kyle Friedrichs,2021,AAA,20,10,8,30,2,0,2,0.0666666666666666,1.0,0.0666666666666666,0,-1
664852,Jay Flaa,2021,AAA,26,10,24,36,9,0,9,0.25,1.0,0.25,0,-1
664871,Kyle Dowdy,2021,AAA,38,30,32,68,5,1,6,0.088235294117647,0.8333333333333334,0.0735294117647058,0,-1
664875,Justin Lawrence,2021,AAA,29,14,20,43,3,1,4,0.0930232558139534,0.75,0.0697674418604651,0,-1
664910,Logan Cozart,2021,AAA,30,19,26,49,10,2,12,0.2448979591836734,0.8333333333333334,0.2040816326530612,0,-1
664918,Kyle Keller,2021,AAA,6,9,9,15,1,0,1,0.0666666666666666,1.0,0.0666666666666666,0,-1
664942,James Naile,2021,AAA,52,21,34,73,1,1,2,0.0273972602739726,0.5,0.0136986301369863,0,-1
664944,Cam Vieaux,2021,AAA,28,14,8,42,3,0,3,0.0714285714285714,1.0,0.0714285714285714,0,-1
665001,Trevor Kelley,2021,AAA,18,9,16,27,0,1,1,0.037037037037037,0.0,0.0,0,-1
665014,Quintin Torres-Costa,2021,AAA,25,19,22,44,4,1,5,0.1136363636363636,0.8,0.0909090909090909,0,-1
665048,Hobie Harris,2021,AAA,21,13,17,34,4,0,4,0.1176470588235294,1.0,0.1176470588235294,0,-1
665093,Zac Grotz,2021,AAA,8,5,6,13,0,0,0,0.0,,0.0,0,-1
665105,Cameron Gann,2021,AAA,20,8,16,28,1,0,1,0.0357142857142857,1.0,0.0357142857142857,0,-1
665134,Tate Scioneaux,2021,AAA,21,13,21,34,1,2,3,0.088235294117647,0.3333333333333333,0.0294117647058823,0,-1
665152,Dean Kremer,2021,AAA,45,9,17,54,4,2,6,0.1111111111111111,0.6666666666666666,0.074074074074074,0,-1
665321,Andrew Schwaab,2021,AAA,14,8,12,22,1,0,1,0.0454545454545454,1.0,0.0454545454545454,0,-1
665417,Kyle Kubat,2021,AAA,23,18,19,41,1,1,2,0.048780487804878,0.5,0.024390243902439,0,-1
665600,Jasseel De La Cruz,2021,AAA,37,25,17,62,7,0,7,0.1129032258064516,1.0,0.1129032258064516,0,-1
665620,Deivi García,2021,AAA,81,41,23,122,13,3,16,0.1311475409836065,0.8125,0.1065573770491803,0,-1
665621,Rony García,2021,AAA,15,1,4,16,1,0,1,0.0625,1.0,0.0625,0,-1
665645,Kervin Castro,2021,AAA,23,10,18,33,3,0,3,0.0909090909090909,1.0,0.0909090909090909,0,-1
665661,Shea Spitzbarth,2021,AAA,30,11,25,41,2,3,5,0.1219512195121951,0.4,0.048780487804878,0,-1
665665,Reiver Sanmartin,2021,AAA,52,30,18,82,1,1,2,0.024390243902439,0.5,0.0121951219512195,0,-1
665733,Antonio Santos,2021,AAA,39,17,22,56,0,0,0,0.0,,0.0,0,-1
665759,Ramón Rosso,2021,AAA,21,13,18,34,4,0,4,0.1176470588235294,1.0,0.1176470588235294,0,-1
665795,Edward Cabrera,2021,AAA,12,12,6,24,4,0,4,0.1666666666666666,1.0,0.1666666666666666,0,-1
665896,José Marte,2021,AAA,9,6,6,15,0,0,0,0.0,,0.0,0,-1
665968,Juan Mota,2021,AAA,13,10,13,23,6,0,6,0.2608695652173913,1.0,0.2608695652173913,0,-1
666005,Andres Sotillet,2021,AAA,16,12,10,28,3,1,4,0.1428571428571428,0.75,0.1071428571428571,0,-1
666120,Ian Anderson,2021,AAA,9,5,4,14,5,0,5,0.3571428571428571,1.0,0.3571428571428571,0,-1
666129,Braxton Garrett,2021,AAA,47,24,18,71,8,3,11,0.1549295774647887,0.7272727272727273,0.1126760563380281,0,-1
666159,Matt Manning,2021,AAA,16,9,6,25,2,0,2,0.08,1.0,0.08,0,-1
666168,Mason Thompson,2021,AAA,14,11,12,25,0,0,0,0.0,,0.0,0,-1
666200,Jesús Luzardo,2021,AAA,22,11,8,33,2,2,4,0.1212121212121212,0.5,0.0606060606060606,0,-1
666204,Dany Jiménez,2021,AAA,29,18,20,47,7,0,7,0.1489361702127659,1.0,0.1489361702127659,0,-1
666205,Kyle Muller,2021,AAA,39,27,17,66,7,1,8,0.1212121212121212,0.875,0.106060606060606,0,-1
666502,Marcelo Martinez,2021,AAA,46,16,18,62,0,1,1,0.0161290322580645,0.0,0.0,0,-1
666563,Jeff Singer,2021,AAA,35,24,28,59,4,0,4,0.0677966101694915,1.0,0.0677966101694915,0,-1
666619,Gregory Santos,2021,AAA,13,8,10,21,1,0,1,0.0476190476190476,1.0,0.0476190476190476,0,-1
666672,Jojanse Torres,2021,AAA,16,9,7,25,2,1,3,0.12,0.6666666666666666,0.08,0,-1
666720,Yerry Rodríguez,2021,AAA,20,13,10,33,4,1,5,0.1515151515151515,0.8,0.1212121212121212,0,-1
666808,Camilo Doval,2021,AAA,20,16,17,36,1,1,2,0.0555555555555555,0.5,0.0277777777777777,0,-1
666818,Luis Frías,2021,AAA,22,7,5,29,2,0,2,0.0689655172413793,1.0,0.0689655172413793,0,-1
666888,Yaisel Sierra,2021,AAA,22,11,16,33,2,0,2,0.0606060606060606,1.0,0.0606060606060606,0,-1
666974,Yennier Cano,2021,AAA,35,17,24,52,4,2,6,0.1153846153846153,0.6666666666666666,0.0769230769230769,0,-1
667050,Grant Gavin,2021,AAA,41,27,33,68,4,0,4,0.0588235294117647,1.0,0.0588235294117647,0,-1
667176,Grant Black,2021,AAA,13,4,8,17,1,1,2,0.1176470588235294,0.5,0.0588235294117647,0,-1
667339,Johan Dominguez,2021,AAA,10,4,2,14,0,0,0,0.0,,0.0,0,-1
667373,Angel Rondón,2021,AAA,41,25,18,66,1,0,1,0.0151515151515151,1.0,0.0151515151515151,0,-1
667376,Miguel Sánchez,2021,AAA,16,10,14,26,1,0,1,0.0384615384615384,1.0,0.0384615384615384,0,-1
667421,Blaine Knight,2021,AAA,23,10,7,33,3,0,3,0.0909090909090909,1.0,0.0909090909090909,0,-1
667427,Zach Jackson,2021,AAA,8,6,7,14,0,0,0,0.0,,0.0,0,-1
667445,Marshall Kasowski,2021,AAA,7,3,6,10,1,0,1,0.1,1.0,0.1,0,-1
667465,Aaron Fletcher,2021,AAA,31,15,26,46,1,1,2,0.0434782608695652,0.5,0.0217391304347826,0,-1
667498,Robert Dugger,2021,AAA,35,20,14,55,3,0,3,0.0545454545454545,1.0,0.0545454545454545,0,-1
667700,Joe Navilhon,2021,AAA,3,7,5,10,1,0,1,0.1,1.0,0.1,0,-1
667712,Austin Hansen,2021,AAA,18,8,9,26,0,0,0,0.0,,0.0,0,-1
667725,Kyle Tyler,2021,AAA,8,3,4,11,0,0,0,0.0,,0.0,0,-1
668338,Tyson Miller,2021,AAA,35,22,18,57,6,0,6,0.1052631578947368,1.0,0.1052631578947368,0,-1
668560,Yeizo Campos,2021,AAA,10,3,7,13,0,0,0,0.0,,0.0,0,-1
668665,Stephen Nogosek,2021,AAA,15,15,16,30,4,0,4,0.1333333333333333,1.0,0.1333333333333333,0,-1
668684,Tanner Tully,2021,AAA,25,14,8,39,1,0,1,0.0256410256410256,1.0,0.0256410256410256,0,-1
668687,Andre Scrubb,2021,AAA,11,5,11,16,0,0,0,0.0,,0.0,0,-1
668754,Braden Bristo,2021,AAA,35,18,25,53,5,1,6,0.1132075471698113,0.8333333333333334,0.0943396226415094,0,-1
668766,Dylan File,2021,AAA,29,11,9,40,3,1,4,0.1,0.75,0.075,0,-1
668820,Max Kranick,2021,AAA,31,14,11,45,4,1,5,0.1111111111111111,0.8,0.0888888888888888,0,-1
668868,Zack Thompson,2021,AAA,63,40,22,103,2,2,4,0.0388349514563106,0.5,0.0194174757281553,0,-1
668869,Tyler Thomas,2021,AAA,10,0,2,10,0,0,0,0.0,,0.0,0,-1
668881,Hunter Greene,2021,AAA,39,15,14,54,5,1,6,0.1111111111111111,0.8333333333333334,0.0925925925925925,0,-1
668948,Kirk McCarty,2021,AAA,61,27,23,88,3,0,3,0.034090909090909,1.0,0.034090909090909,0,-1
668954,Curtis Taylor,2021,AAA,16,6,13,22,0,0,0,0.0,,0.0,0,-1
668964,Tobias Myers,2021,AAA,30,11,11,41,2,1,3,0.073170731707317,0.6666666666666666,0.048780487804878,0,-1
669020,Ryan Rolison,2021,AAA,24,14,10,38,1,2,3,0.0789473684210526,0.3333333333333333,0.0263157894736842,0,-1
669022,MacKenzie Gore,2021,AAA,13,9,5,22,2,0,2,0.0909090909090909,1.0,0.0909090909090909,0,-1
669060,Bryse Wilson,2021,AAA,34,12,10,46,2,1,3,0.0652173913043478,0.6666666666666666,0.0434782608695652,0,-1
669081,Jack Dashwood,2021,AAA,16,10,6,26,5,1,6,0.2307692307692307,0.8333333333333334,0.1923076923076923,0,-1
669114,Jace Vines,2021,AAA,42,26,28,68,6,1,7,0.1029411764705882,0.8571428571428571,0.088235294117647,0,-1
669145,Bruce Zimmermann,2021,AAA,6,4,4,10,2,0,2,0.2,1.0,0.2,0,-1
669180,Braeden Ogle,2021,AAA,43,24,36,67,4,1,5,0.0746268656716417,0.8,0.0597014925373134,0,-1
669212,Eli Morgan,2021,AAA,14,7,5,21,4,0,4,0.1904761904761904,1.0,0.1904761904761904,0,-1
669214,Conner Menez,2021,AAA,33,23,22,56,3,1,4,0.0714285714285714,0.75,0.0535714285714285,0,-1
669276,Dylan Lee,2021,AAA,13,8,15,21,0,0,0,0.0,,0.0,0,-1
669345,Brett Conine,2021,AAA,58,38,24,96,3,1,4,0.0416666666666666,0.75,0.03125,0,-1
669358,Shane Baz,2021,AAA,19,7,8,26,1,1,2,0.0769230769230769,0.5,0.0384615384615384,0,-1
669395,Dylan Coleman,2021,AAA,14,12,14,26,2,0,2,0.0769230769230769,1.0,0.0769230769230769,0,-1
669424,Jimmy Lambert,2021,AAA,46,16,18,62,12,5,17,0.2741935483870967,0.7058823529411765,0.1935483870967742,0,-1
669459,Kyle Nelson,2021,AAA,15,12,12,27,2,0,2,0.074074074074074,1.0,0.074074074074074,0,-1
669461,Matthew Liberatore,2021,AAA,71,35,22,106,8,2,10,0.0943396226415094,0.8,0.0754716981132075,0,-1
669468,Aaron Leasher,2021,AAA,14,7,4,21,1,0,1,0.0476190476190476,1.0,0.0476190476190476,0,-1
669674,Sam Long,2021,AAA,12,5,9,17,0,0,0,0.0,,0.0,0,-1
669711,Greg Weissert,2021,AAA,29,10,17,39,3,1,4,0.1025641025641025,0.75,0.0769230769230769,0,-1
669713,Hayden Wesneski,2021,AAA,9,3,2,12,0,0,0,0.0,,0.0,0,-1
669721,Davis Daniel,2021,AAA,11,8,4,19,1,0,1,0.0526315789473684,1.0,0.0526315789473684,0,-1
669725,Thomas Jankins,2021,AAA,55,29,22,84,2,1,3,0.0357142857142857,0.6666666666666666,0.0238095238095238,0,-1
669728,Dakota Mekkes,2021,AAA,24,14,19,38,0,1,1,0.0263157894736842,0.0,0.0,0,-1
669735,Chris Rodriguez,2021,AAA,7,3,3,10,0,1,1,0.1,0.0,0.0,0,-1
669746,Tommy Eveld,2021,AAA,22,18,22,40,5,1,6,0.15,0.8333333333333334,0.125,0,-1
669804,Angel De Jesus,2021,AAA,29,18,23,47,5,3,8,0.1702127659574468,0.625,0.1063829787234042,0,-1
669854,Ronel Blanco,2021,AAA,16,8,17,24,2,0,2,0.0833333333333333,1.0,0.0833333333333333,0,-1
669912,Kirby Snead,2021,AAA,25,9,17,34,3,0,3,0.088235294117647,1.0,0.088235294117647,0,-1
669920,Jason Alexander,2021,AAA,10,5,5,15,0,0,0,0.0,,0.0,0,-1
669935,A.J. Alexy,2021,AAA,9,2,3,11,1,1,2,0.1818181818181818,0.5,0.0909090909090909,0,-1
669942,Chad Donato,2021,AAA,15,9,9,24,2,0,2,0.0833333333333333,1.0,0.0833333333333333,0,-1
669947,Jesse Scholtens,2021,AAA,63,32,20,95,8,1,9,0.0947368421052631,0.8888888888888888,0.0842105263157894,0,-1
669952,Mitch White,2021,AAA,20,8,9,28,3,0,3,0.1071428571428571,1.0,0.1071428571428571,0,-1
670036,Matt Festa,2021,AAA,5,6,8,11,4,0,4,0.3636363636363636,1.0,0.3636363636363636,0,-1
670046,Kenny Rosenberg,2021,AAA,21,10,12,31,0,5,5,0.1612903225806451,0.0,0.0,0,-1
670050,Stephen Ridings,2021,AAA,7,4,6,11,4,0,4,0.3636363636363636,1.0,0.3636363636363636,0,-1
670056,Caleb Baragar,2021,AAA,19,9,16,28,3,0,3,0.1071428571428571,1.0,0.1071428571428571,0,-1
670057,Ryan Hartman,2021,AAA,55,27,21,82,2,2,4,0.048780487804878,0.5,0.024390243902439,0,-1
670062,Julian Garcia,2021,AAA,26,15,13,41,2,1,3,0.073170731707317,0.6666666666666666,0.048780487804878,0,-1
670065,Trevor Lane,2021,AAA,12,11,13,23,4,0,4,0.1739130434782608,1.0,0.1739130434782608,0,-1
670081,Scott Engler,2021,AAA,29,14,16,43,1,0,1,0.0232558139534883,1.0,0.0232558139534883,0,-1
670087,Brandyn Sittinger,2021,AAA,12,4,11,16,0,0,0,0.0,,0.0,0,-1
670090,Wyatt Mills,2021,AAA,7,5,8,12,2,0,2,0.1666666666666666,1.0,0.1666666666666666,0,-1
670102,Bowden Francis,2021,AAA,51,19,20,70,6,2,8,0.1142857142857142,0.75,0.0857142857142857,0,-1
670104,Colin McKee,2021,AAA,24,13,20,37,0,0,0,0.0,,0.0,0,-1
670124,Adam Oller,2021,AAA,23,10,8,33,3,1,4,0.1212121212121212,0.75,0.0909090909090909,0,-1
670154,Nolan Blackwood,2021,AAA,46,24,28,70,1,0,1,0.0142857142857142,1.0,0.0142857142857142,0,-1
670161,Parker Dunshee,2021,AAA,30,13,10,43,1,0,1,0.0232558139534883,1.0,0.0232558139534883,0,-1
670167,John Schreiber,2021,AAA,53,20,21,73,0,0,0,0.0,,0.0,0,-1
670288,Jake Fishman,2021,AAA,28,19,23,47,5,2,7,0.1489361702127659,0.7142857142857143,0.1063829787234042,0,-1
670328,Juan Gámez,2021,AAA,21,17,14,38,2,0,2,0.0526315789473684,1.0,0.0526315789473684,0,-1
670343,Matt Milburn,2021,AAA,14,7,8,21,0,0,0,0.0,,0.0,0,-1
670377,Evan Miller,2021,AAA,60,31,34,91,7,1,8,0.0879120879120879,0.875,0.0769230769230769,0,-1
670381,Fred Villarreal,2021,AAA,10,4,3,14,0,0,0,0.0,,0.0,0,-1
670426,Phillip Diehl,2021,AAA,22,12,24,34,0,0,0,0.0,,0.0,0,-1
670456,JD Hammer,2021,AAA,11,10,13,21,3,1,4,0.1904761904761904,0.75,0.1428571428571428,0,-1
670550,Nivaldo Rodriguez,2021,AAA,47,25,22,72,2,0,2,0.0277777777777777,1.0,0.0277777777777777,0,-1
670766,Darren McCaughan,2021,AAA,54,22,20,76,4,2,6,0.0789473684210526,0.6666666666666666,0.0526315789473684,0,-1
670912,Johan Oviedo,2021,AAA,46,26,12,72,7,0,7,0.0972222222222222,1.0,0.0972222222222222,0,-1
670955,Edwin Uceta,2021,AAA,23,10,10,33,1,0,1,0.0303030303030303,1.0,0.0303030303030303,0,-1
670990,Yohan Ramírez,2021,AAA,13,6,9,19,0,0,0,0.0,,0.0,0,-1
671162,Connor Thomas,2021,AAA,71,41,20,112,5,6,11,0.0982142857142857,0.4545454545454545,0.0446428571428571,0,-1
671345,Jason Foley,2021,AAA,33,14,26,47,6,0,6,0.1276595744680851,1.0,0.1276595744680851,0,-1
671790,Ronald Bolaños,2021,AAA,32,11,9,43,2,1,3,0.0697674418604651,0.6666666666666666,0.0465116279069767,0,-1
672335,Cionel Pérez,2021,AAA,16,12,16,28,2,0,2,0.0714285714285714,1.0,0.0714285714285714,0,-1
672391,Kaleb Ort,2021,AAA,29,12,24,41,4,0,4,0.0975609756097561,1.0,0.0975609756097561,0,-1
672578,Carlos Hernández,2021,AAA,12,6,5,18,1,0,1,0.0555555555555555,1.0,0.0555555555555555,0,-1
672715,Luis Patiño,2021,AAA,15,4,6,19,3,0,3,0.1578947368421052,1.0,0.1578947368421052,0,-1
672859,Edward Cuello,2021,AAA,12,4,9,16,1,0,1,0.0625,1.0,0.0625,0,-1
672911,Jesus Cruz,2021,AAA,22,15,21,37,2,0,2,0.054054054054054,1.0,0.054054054054054,0,-1
673316,Luke Barker,2021,AAA,24,13,23,37,1,2,3,0.081081081081081,0.3333333333333333,0.027027027027027,0,-1
673360,West Tunnell,2021,AAA,9,7,7,16,0,0,0,0.0,,0.0,0,-1
673603,Luis Romero,2021,AAA,63,23,24,86,6,0,6,0.0697674418604651,1.0,0.0697674418604651,0,-1
673862,Ethan Evanko,2021,AAA,18,5,10,23,5,1,6,0.2608695652173913,0.8333333333333334,0.217391304347826,0,-1
673933,David Lebron,2021,AAA,7,5,4,12,2,1,3,0.25,0.6666666666666666,0.1666666666666666,0,-1
674342,Jakob Hernandez,2021,AAA,23,16,21,39,5,0,5,0.1282051282051282,1.0,0.1282051282051282,0,-1
674370,Osvaldo Bido,2021,AAA,11,2,2,13,1,0,1,0.0769230769230769,1.0,0.0769230769230769,0,-1
674944,Sean Guenther,2021,AAA,8,8,9,16,0,0,0,0.0,,0.0,0,-1
675640,Braden Zarbnisky,2021,AAA,7,7,5,14,1,0,1,0.0714285714285714,1.0,0.0714285714285714,0,-1
675652,Matt Tabor,2021,AAA,23,13,8,36,8,2,10,0.2777777777777778,0.8,0.2222222222222222,0,-1
675912,Zac Lowther,2021,AAA,23,13,8,36,7,0,7,0.1944444444444444,1.0,0.1944444444444444,0,-1
675921,Spencer Howard,2021,AAA,11,6,7,17,2,0,2,0.1176470588235294,1.0,0.1176470588235294,0,-1
675971,Kyle Dohy,2021,AAA,7,6,5,13,1,0,1,0.0769230769230769,1.0,0.0769230769230769,0,-1
675977,Drew Strotman,2021,AAA,91,39,25,130,7,4,11,0.0846153846153846,0.6363636363636364,0.0538461538461538,0,-1
676050,Packy Naughton,2021,AAA,30,17,12,47,0,0,0,0.0,,0.0,0,-1
676092,Collin Snider,2021,AAA,23,15,15,38,3,0,3,0.0789473684210526,1.0,0.0789473684210526,0,-1
676103,Damon Jones,2021,AAA,32,23,27,55,8,2,10,0.1818181818181818,0.8,0.1454545454545454,0,-1
676220,Seth Elledge,2021,AAA,32,12,21,44,5,2,7,0.1590909090909091,0.7142857142857143,0.1136363636363636,0,-1
676265,Cory Abbott,2021,AAA,58,27,19,85,13,4,17,0.2,0.7647058823529411,0.1529411764705882,0,-1
676337,Connor Higgins,2021,AAA,8,5,5,13,0,0,0,0.0,,0.0,0,-1
676344,Marcel Rentería,2021,AAA,15,12,9,27,5,0,5,0.1851851851851851,1.0,0.1851851851851851,0,-1
676358,Evan Kruczynski,2021,AAA,17,4,11,21,1,0,1,0.0476190476190476,1.0,0.0476190476190476,0,-1
676424,Alec Bettinger,2021,AAA,48,34,19,82,4,2,6,0.073170731707317,0.6666666666666666,0.048780487804878,0,-1
676520,Manuel Alvarez,2021,AAA,7,6,7,13,2,1,3,0.2307692307692307,0.6666666666666666,0.1538461538461538,0,-1
676534,Calvin Faucher,2021,AAA,10,5,8,15,0,1,1,0.0666666666666666,0.0,0.0,0,-1
676599,Jason Bahr,2021,AAA,26,12,16,38,1,4,5,0.131578947368421,0.2,0.0263157894736842,0,-1
676601,Logan Salow,2021,AAA,28,18,22,46,6,1,7,0.1521739130434782,0.8571428571428571,0.1304347826086956,0,-1
676604,Tyler Zuber,2021,AAA,15,7,13,22,2,0,2,0.0909090909090909,1.0,0.0909090909090909,0,-1
676607,Hunter Schryver,2021,AAA,28,28,27,56,2,0,2,0.0357142857142857,1.0,0.0357142857142857,0,-1
676611,Max Roberts,2021,AAA,11,5,6,16,0,0,0,0.0,,0.0,0,-1
676614,Bryan Sammons,2021,AAA,35,22,13,57,6,0,6,0.1052631578947368,1.0,0.1052631578947368,0,-1
676617,Riley O'Brien,2021,AAA,63,39,22,102,9,0,9,0.088235294117647,1.0,0.088235294117647,0,-1
676620,Blake Weiman,2021,AAA,22,16,22,38,3,0,3,0.0789473684210526,1.0,0.0789473684210526,0,-1
676637,Phoenix Sanders,2021,AAA,24,13,23,37,0,0,0,0.0,,0.0,0,-1
676641,Beau Sulser,2021,AAA,101,38,26,139,1,2,3,0.0215827338129496,0.3333333333333333,0.0071942446043165,0,-1
676662,Alex Manasa,2021,AAA,4,8,1,12,2,0,2,0.1666666666666666,1.0,0.1666666666666666,0,-1
676664,JP Sears,2021,AAA,27,11,9,38,8,2,10,0.2631578947368421,0.8,0.2105263157894736,0,-1
676684,Will Vest,2021,AAA,16,9,12,25,0,0,0,0.0,,0.0,0,-1
676702,Hunter Stratton,2021,AAA,9,7,9,16,0,0,0,0.0,,0.0,0,-1
676709,Ty Tice,2021,AAA,15,8,12,23,5,0,5,0.217391304347826,1.0,0.217391304347826,0,-1
676710,Kutter Crawford,2021,AAA,29,17,10,46,2,1,3,0.0652173913043478,0.6666666666666666,0.0434782608695652,0,-1
676720,Tommy Romero,2021,AAA,25,8,11,33,3,0,3,0.0909090909090909,1.0,0.0909090909090909,0,-1
676754,Addison Russ,2021,AAA,13,5,7,18,0,1,1,0.0555555555555555,0.0,0.0,0,-1
676755,Isaac Mattson,2021,AAA,13,7,11,20,0,0,0,0.0,,0.0,0,-1
676760,Ron Marinaccio,2021,AAA,13,7,14,20,2,2,4,0.2,0.5,0.1,0,-1
676831,Kodi Whitley,2021,AAA,4,6,7,10,0,0,0,0.0,,0.0,0,-1
676879,Aaron Ashby,2021,AAA,43,22,20,65,8,0,8,0.123076923076923,1.0,0.123076923076923,0,-1
676886,Jeremy Beasley,2021,AAA,14,6,11,20,6,0,6,0.3,1.0,0.3,0,-1
676891,Alex FaGalde,2021,AAA,7,4,6,11,2,0,2,0.1818181818181818,1.0,0.1818181818181818,0,-1
676917,Cade Cavalli,2021,AAA,21,14,6,35,9,0,9,0.2571428571428571,1.0,0.2571428571428571,0,-1
676946,Matthew Batten,2021,AAA,4,6,2,10,0,0,0,0.0,,0.0,0,-1
676957,Taylor Ahearn,2021,AAA,10,4,2,14,1,0,1,0.0714285714285714,1.0,0.0714285714285714,0,-1
676961,Caleb Boushley,2021,AAA,54,30,15,84,8,1,9,0.1071428571428571,0.8888888888888888,0.0952380952380952,0,-1
677020,Josh Walker,2021,AAA,29,11,9,40,3,1,4,0.1,0.75,0.075,0,-1
677161,Zack Kelly,2021,AAA,7,5,8,12,2,0,2,0.1666666666666666,1.0,0.1666666666666666,0,-1
677369,Austin Warner,2021,AAA,58,24,27,82,3,0,3,0.0365853658536585,1.0,0.0365853658536585,0,-1
677415,Kit Scheetz,2021,AAA,38,21,26,59,2,1,3,0.0508474576271186,0.6666666666666666,0.0338983050847457,0,-1
677742,Tyler Zombro,2021,AAA,8,5,5,13,0,0,0,0.0,,0.0,0,-1
677865,Justin Bruihl,2021,AAA,10,4,11,14,2,0,2,0.1428571428571428,1.0,0.1428571428571428,0,-1
677960,Ryan Weathers,2021,AAA,10,1,2,11,0,0,0,0.0,,0.0,0,-1
677976,Randy Dobnak,2021,AAA,14,4,4,18,1,0,1,0.0555555555555555,1.0,0.0555555555555555,0,-1
678061,Ray Kerr,2021,AAA,9,1,7,10,2,0,2,0.2,1.0,0.2,0,-1
679327,Reeves Martin,2021,AAA,6,4,5,10,2,1,3,0.3,0.6666666666666666,0.2,0,-1
680430,Nick Allgeyer,2021,AAA,64,35,22,99,3,3,6,0.0606060606060606,0.5,0.0303030303030303,0,-1
680692,Jonathan Stiever,2021,AAA,42,23,17,65,8,1,9,0.1384615384615384,0.8888888888888888,0.123076923076923,0,-1
680694,Kyle Bradish,2021,AAA,52,25,20,77,1,0,1,0.0129870129870129,1.0,0.0129870129870129,0,-1
680735,Austin Cox,2021,AAA,7,3,2,10,0,0,0,0.0,,0.0,0,-1
680802,Ryan Weiss,2021,AAA,15,18,15,33,1,1,2,0.0606060606060606,0.5,0.0303030303030303,0,-1
680940,Robert Broom,2021,AAA,44,13,29,57,11,3,14,0.2456140350877192,0.7857142857142857,0.1929824561403508,0,-1
681401,Josh Green,2021,AAA,88,33,25,121,2,1,3,0.024793388429752,0.6666666666666666,0.0165289256198347,0,-1
681407,Blake Whitney,2021,AAA,10,7,9,17,2,0,2,0.1176470588235294,1.0,0.1176470588235294,0,-1
681792,Adam Scott,2021,AAA,8,5,3,13,1,0,1,0.0769230769230769,1.0,0.0769230769230769,0,-1
681799,Ethan Roberts,2021,AAA,6,12,10,18,0,0,0,0.0,,0.0,0,-1
681806,Andrew Wantz,2021,AAA,12,7,10,19,0,2,2,0.1052631578947368,0.0,0.0,0,-1
681810,Austin Warren,2021,AAA,23,17,19,40,2,0,2,0.05,1.0,0.05,0,-1
681835,Jose Quezada,2021,AAA,12,4,9,16,4,0,4,0.25,1.0,0.25,0,-1
681867,Cooper Criswell,2021,AAA,37,14,9,51,0,1,1,0.0196078431372549,0.0,0.0,0,-1
681869,Shawn Dubin,2021,AAA,30,10,14,40,2,1,3,0.075,0.6666666666666666,0.05,0,-1
681973,Josh Hendrickson,2021,AAA,4,6,1,10,0,0,0,0.0,,0.0,0,-1
682010,Lane Ramsey,2021,AAA,20,11,16,31,6,0,6,0.1935483870967742,1.0,0.1935483870967742,0,-1
682027,Cam Alldred,2021,AAA,9,3,5,12,0,0,0,0.0,,0.0,0,-1
682044,Sean Boyle,2021,AAA,15,2,6,17,2,0,2,0.1176470588235294,1.0,0.1176470588235294,0,-1
682125,Tyler Joyner,2021,AAA,7,3,5,10,0,0,0,0.0,,0.0,0,-1
682171,Penn Murfee,2021,AAA,13,6,7,19,3,0,3,0.1578947368421052,1.0,0.1578947368421052,0,-1
682175,Joe Jacques,2021,AAA,31,18,27,49,3,2,5,0.1020408163265306,0.6,0.0612244897959183,0,-1
682201,Austin Ross,2021,AAA,9,3,6,12,2,0,2,0.1666666666666666,1.0,0.1666666666666666,0,-1
682418,Tommy Parsons,2021,AAA,34,16,18,50,2,2,4,0.08,0.5,0.04,0,-1
682615,John O'Reilly,2021,AAA,31,15,13,46,0,0,0,0.0,,0.0,0,-1
683232,Nick Mears,2021,AAA,11,6,9,17,3,1,4,0.2352941176470588,0.75,0.1764705882352941,0,-1
685493,Shun Yamaguchi,2021,AAA,12,8,5,20,0,0,0,0.0,,0.0,0,-1
686613,Hunter Brown,2021,AAA,24,18,11,42,2,0,2,0.0476190476190476,1.0,0.0476190476190476,0,-1
686752,Ryan Pepiot,2021,AAA,33,14,10,47,0,0,0,0.0,,0.0,0,-1
686768,Ryan Smith,2021,AAA,12,5,5,17,1,0,1,0.0588235294117647,1.0,0.0588235294117647,0,-1
687190,Adam Leverett,2021,AAA,11,5,2,16,3,1,4,0.25,0.75,0.1875,0,-1
687504,Jordan Martinson,2021,AAA,9,5,8,14,0,0,0,0.0,,0.0,0,-1
693821,Bryce Elder,2021,AAA,20,12,5,32,3,0,3,0.09375,1.0,0.09375,0,-1
699499,Mike Adams,2021,AAA,30,11,23,41,2,1,3,0.073170731707317,0.6666666666666666,0.048780487804878,0,-1
433589,Yusmeiro Petit,2022,AAA,8,3,6,11,1,0,1,0.0909090909090909,1.0,0.0909090909090909,1,0
434671,Aníbal Sánchez,2022,AAA,12,4,3,16,3,0,3,0.1875,1.0,0.1875,1,0
446321,Ross Detwiler,2022,AAA,6,5,6,11,2,1,3,0.2727272727272727,0.6666666666666666,0.1818181818181818,1,0
453284,Blake Parker,2022,AAA,17,11,13,28,5,0,5,0.1785714285714285,1.0,0.1785714285714285,1,0
456501,Johnny Cueto,2022,AAA,7,3,4,10,0,0,0,0.0,,0.0,1,0
458676,Josh Lindblom,2022,AAA,60,23,26,83,7,1,8,0.0963855421686747,0.875,0.0843373493975903,1,0
461325,Tyler Clippard,2022,AAA,20,12,16,32,13,0,13,0.40625,1.0,0.40625,1,0
472551,Fernando Abad,2022,AAA,22,13,16,35,3,0,3,0.0857142857142857,1.0,0.0857142857142857,1,0
476454,Dellin Betances,2022,AAA,14,4,12,18,5,0,5,0.2777777777777778,1.0,0.2777777777777778,1,0
489119,Wade Miley,2022,AAA,12,5,4,17,1,0,1,0.0588235294117647,1.0,0.0588235294117647,1,0
491624,César Valdez,2022,AAA,73,45,23,118,7,1,8,0.0677966101694915,0.875,0.059322033898305,1,0
500724,JC Ramírez,2022,AAA,25,18,15,43,10,0,10,0.2325581395348837,1.0,0.2325581395348837,1,0
501381,Michael Pineda,2022,AAA,14,7,7,21,3,1,4,0.1904761904761904,0.75,0.1428571428571428,1,0
501593,Luis Avilán,2022,AAA,18,6,13,24,4,0,4,0.1666666666666666,1.0,0.1666666666666666,1,0
501697,Jhan Mariñez,2022,AAA,17,14,11,31,1,2,3,0.0967741935483871,0.3333333333333333,0.032258064516129,1,0
501985,Mike Minor,2022,AAA,9,5,3,14,2,0,2,0.1428571428571428,1.0,0.1428571428571428,1,0
502083,Zach McAllister,2022,AAA,43,20,34,63,11,1,12,0.1904761904761904,0.9166666666666666,0.1746031746031746,1,0
502239,Trevor Cahill,2022,AAA,23,11,8,34,5,1,6,0.1764705882352941,0.8333333333333334,0.1470588235294117,1,0
502578,Aaron Barrett,2022,AAA,13,9,10,22,2,0,2,0.0909090909090909,1.0,0.0909090909090909,1,0
502593,Jake Petricka,2022,AAA,14,8,14,22,2,0,2,0.0909090909090909,1.0,0.0909090909090909,1,0
502624,Chase Anderson,2022,AAA,44,20,19,64,11,1,12,0.1875,0.9166666666666666,0.171875,1,0
502706,Derek Holland,2022,AAA,29,16,23,45,5,2,7,0.1555555555555555,0.7142857142857143,0.1111111111111111,1,0
502748,Brad Peacock,2022,AAA,37,18,30,55,5,0,5,0.0909090909090909,1.0,0.0909090909090909,1,0
503569,Rafael Dolis,2022,AAA,16,14,14,30,6,0,6,0.2,1.0,0.2,1,0
518464,Seth Blair,2022,AAA,19,14,15,33,6,0,6,0.1818181818181818,1.0,0.1818181818181818,1,0
518566,Taylor Cole,2022,AAA,20,9,14,29,2,0,2,0.0689655172413793,1.0,0.0689655172413793,1,0
518585,Fernando Cruz,2022,AAA,31,15,31,46,5,0,5,0.108695652173913,1.0,0.108695652173913,1,0
518693,Sam Freeman,2022,AAA,18,13,21,31,1,1,2,0.064516129032258,0.5,0.032258064516129,1,0
518774,Matt Harvey,2022,AAA,31,10,10,41,4,3,7,0.1707317073170731,0.5714285714285714,0.0975609756097561,1,0
519008,T.J. McFarland,2022,AAA,13,6,10,19,3,2,5,0.2631578947368421,0.6,0.1578947368421052,1,0
519393,Marcus Walden,2022,AAA,41,21,14,62,8,0,8,0.1290322580645161,1.0,0.1290322580645161,1,0
520980,Pedro Báez,2022,AAA,3,9,5,12,3,0,3,0.25,1.0,0.25,1,0
527055,Arodys Vizcaíno,2022,AAA,7,5,6,12,0,0,0,0.0,,0.0,1,0
532936,Mario Sanchez,2022,AAA,50,17,23,67,5,3,8,0.1194029850746268,0.625,0.0746268656716417,1,0
534947,Tim Adleman,2022,AAA,29,8,16,37,4,2,6,0.1621621621621621,0.6666666666666666,0.1081081081081081,1,0
542960,Brad Brach,2022,AAA,17,6,13,23,1,0,1,0.0434782608695652,1.0,0.0434782608695652,1,0
543208,Sam Gaviglio,2022,AAA,48,22,17,70,12,0,12,0.1714285714285714,1.0,0.1714285714285714,1,0
543351,Jay Jackson,2022,AAA,11,5,10,16,4,0,4,0.25,1.0,0.25,1,0
543548,Tommy Milone,2022,AAA,18,6,10,24,4,2,6,0.25,0.6666666666666666,0.1666666666666666,1,0
543557,Mike Montgomery,2022,AAA,50,30,22,80,10,2,12,0.15,0.8333333333333334,0.125,1,0
543859,Michael Tonkin,2022,AAA,30,13,23,43,3,1,4,0.0930232558139534,0.75,0.0697674418604651,1,0
543883,Nick Vincent,2022,AAA,23,11,22,34,1,0,1,0.0294117647058823,1.0,0.0294117647058823,1,0
543901,Ryan Weber,2022,AAA,22,15,12,37,4,1,5,0.1351351351351351,0.8,0.1081081081081081,1,0
544365,Manny Bañuelos,2022,AAA,19,13,7,32,4,0,4,0.125,1.0,0.125,1,0
545343,Louis Head,2022,AAA,9,5,9,14,0,0,0,0.0,,0.0,1,0
545346,Zach Lee,2022,AAA,35,25,35,60,1,0,1,0.0166666666666666,1.0,0.0166666666666666,1,0
547184,Michael Kelly,2022,AAA,31,20,27,51,6,1,7,0.1372549019607843,0.8571428571428571,0.1176470588235294,1,0
547185,Peter Tago,2022,AAA,6,7,6,13,0,0,0,0.0,,0.0,1,0
548337,Logan Verrett,2022,AAA,76,47,22,123,17,3,20,0.1626016260162601,0.85,0.1382113821138211,1,0
554241,Andy Otero,2022,AAA,24,9,13,33,0,0,0,0.0,,0.0,1,0
570240,Félix Peña,2022,AAA,20,8,7,28,2,1,3,0.1071428571428571,0.6666666666666666,0.0714285714285714,1,0
570488,Phillips Valdez,2022,AAA,31,17,24,48,6,1,7,0.1458333333333333,0.8571428571428571,0.125,1,0
570632,José Ureña,2022,AAA,26,10,5,36,1,2,3,0.0833333333333333,0.3333333333333333,0.0277777777777777,1,0
570663,Hansel Robles,2022,AAA,12,5,12,17,6,0,6,0.3529411764705882,1.0,0.3529411764705882,1,0
571439,R.J. Alvarez,2022,AAA,37,26,25,63,7,1,8,0.1269841269841269,0.875,0.1111111111111111,1,0
571446,Mark Appel,2022,AAA,31,14,17,45,1,0,1,0.0222222222222222,1.0,0.0222222222222222,1,0
571521,Rex Brothers,2022,AAA,6,5,5,11,0,0,0,0.0,,0.0,1,0
571539,Matt Carasiti,2022,AAA,15,12,16,27,2,0,2,0.074074074074074,1.0,0.074074074074074,1,0
571616,Matt Dermody,2022,AAA,50,23,20,73,5,1,6,0.0821917808219178,0.8333333333333334,0.0684931506849315,1,0
571638,James Dykstra,2022,AAA,7,3,6,10,4,0,4,0.4,1.0,0.4,1,0
571656,Buck Farmer,2022,AAA,12,3,9,15,4,0,4,0.2666666666666666,1.0,0.2666666666666666,1,0
571800,Drew Hutchison,2022,AAA,8,3,4,11,5,0,5,0.4545454545454545,1.0,0.4545454545454545,1,0
571825,James Jones,2022,AAA,5,6,8,11,0,0,0,0.0,,0.0,1,0
571863,Matt Koch,2022,AAA,12,9,14,21,2,0,2,0.0952380952380952,1.0,0.0952380952380952,1,0
571871,Ian Krol,2022,AAA,21,11,17,32,4,0,4,0.125,1.0,0.125,1,0
571882,Derek Law,2022,AAA,32,13,26,45,1,0,1,0.0222222222222222,1.0,0.0222222222222222,1,0
571917,Parker Markel,2022,AAA,28,16,25,44,6,0,6,0.1363636363636363,1.0,0.1363636363636363,1,0
571946,Shelby Miller,2022,AAA,25,20,27,45,12,3,15,0.3333333333333333,0.8,0.2666666666666666,1,0
571951,Bryan Mitchell,2022,AAA,20,11,9,31,2,0,2,0.064516129032258,1.0,0.064516129032258,1,0
572125,Sam Selman,2022,AAA,18,5,15,23,0,0,0,0.0,,0.0,1,0
572362,Robbie Erlin,2022,AAA,52,29,20,81,8,1,9,0.1111111111111111,0.8888888888888888,0.0987654320987654,1,0
572371,Tyler Higgins,2022,AAA,13,10,18,23,2,0,2,0.0869565217391304,1.0,0.0869565217391304,1,0
572383,Brian Moran,2022,AAA,25,21,30,46,2,0,2,0.0434782608695652,1.0,0.0434782608695652,1,0
572703,Luke Bard,2022,AAA,20,12,18,32,5,0,5,0.15625,1.0,0.15625,1,0
572888,Shane Greene,2022,AAA,28,9,19,37,4,0,4,0.1081081081081081,1.0,0.1081081081081081,1,0
572971,Dallas Keuchel,2022,AAA,11,5,4,16,0,0,0,0.0,,0.0,1,0
573062,Aaron Northcraft,2022,AAA,20,11,18,31,4,0,4,0.1290322580645161,1.0,0.1290322580645161,1,0
573127,Zac Rosscup,2022,AAA,17,10,18,27,3,0,3,0.1111111111111111,1.0,0.1111111111111111,1,0
573185,Dan Straily,2022,AAA,41,10,15,51,4,0,4,0.0784313725490196,1.0,0.0784313725490196,1,0
573668,Juan Minaya,2022,AAA,34,21,25,55,4,0,4,0.0727272727272727,1.0,0.0727272727272727,1,0
592165,Brandon Brennan,2022,AAA,24,15,19,39,5,0,5,0.1282051282051282,1.0,0.1282051282051282,1,0
592169,Austin Brice,2022,AAA,28,15,21,43,7,0,7,0.1627906976744186,1.0,0.1627906976744186,1,0
592222,Alex Claudio,2022,AAA,31,19,23,50,1,3,4,0.08,0.25,0.02,1,0
592254,José De León,2022,AAA,7,3,7,10,1,0,1,0.1,1.0,0.1,1,0
592288,Kent Emanuel,2022,AAA,24,11,8,35,0,2,2,0.0571428571428571,0.0,0.0,1,0
592346,Chi Chi González,2022,AAA,55,22,16,77,2,2,4,0.0519480519480519,0.5,0.0259740259740259,1,0
592455,Jake Kalish,2022,AAA,56,10,17,66,7,2,9,0.1363636363636363,0.7777777777777778,0.106060606060606,1,0
592473,Adam Kolarek,2022,AAA,33,15,25,48,1,0,1,0.0208333333333333,1.0,0.0208333333333333,1,0
592527,Michael Mariot,2022,AAA,43,18,16,61,2,1,3,0.0491803278688524,0.6666666666666666,0.0327868852459016,1,0
592547,Deck McGuire,2022,AAA,55,19,20,74,15,0,15,0.2027027027027027,1.0,0.2027027027027027,1,0
592593,Justin Nicolino,2022,AAA,46,26,18,72,16,2,18,0.25,0.8888888888888888,0.2222222222222222,1,0
592614,Dillon Overton,2022,AAA,32,25,11,57,9,3,12,0.2105263157894736,0.75,0.1578947368421052,1,0
592712,Connor Sadzeck,2022,AAA,24,10,22,34,3,4,7,0.2058823529411764,0.4285714285714285,0.088235294117647,1,0
592716,Adrian Sampson,2022,AAA,19,5,7,24,3,0,3,0.125,1.0,0.125,1,0
592717,Aaron Sanchez,2022,AAA,42,18,13,60,15,3,18,0.3,0.8333333333333334,0.25,1,0
592804,Tyler Thornburg,2022,AAA,13,10,10,23,2,0,2,0.0869565217391304,1.0,0.0869565217391304,1,0
592831,Konner Wade,2022,AAA,76,31,24,107,9,4,13,0.1214953271028037,0.6923076923076923,0.0841121495327102,1,0
592848,Zack Weiss,2022,AAA,31,22,28,53,8,0,8,0.1509433962264151,1.0,0.1509433962264151,1,0
592865,Taylor Williams,2022,AAA,50,24,32,74,8,2,10,0.1351351351351351,0.8,0.1081081081081081,1,0
592879,Asher Wojciechowski,2022,AAA,12,11,6,23,1,0,1,0.0434782608695652,1.0,0.0434782608695652,1,0
593140,Michael Feliz,2022,AAA,27,13,20,40,5,0,5,0.125,1.0,0.125,1,0
593144,Richard Rodríguez,2022,AAA,6,5,5,11,0,0,0,0.0,,0.0,1,0
593604,Alberto Baldonado,2022,AAA,28,15,27,43,6,2,8,0.1860465116279069,0.75,0.1395348837209302,1,0
593619,Domingo Tapia,2022,AAA,28,7,23,35,2,0,2,0.0571428571428571,1.0,0.0571428571428571,1,0
593833,Wander Suero,2022,AAA,20,15,16,35,8,0,8,0.2285714285714285,1.0,0.2285714285714285,1,0
594577,Mike Mayers,2022,AAA,19,7,8,26,1,0,1,0.0384615384615384,1.0,0.0384615384615384,1,0
594795,Grant Dayton,2022,AAA,27,16,24,43,4,0,4,0.0930232558139534,1.0,0.0930232558139534,1,0
594902,Ben Lively,2022,AAA,48,31,18,79,14,1,15,0.189873417721519,0.9333333333333332,0.1772151898734177,1,0
594943,Zach Neal,2022,AAA,74,34,26,108,8,0,8,0.074074074074074,1.0,0.074074074074074,1,0
594965,Daniel Ponce de Leon,2022,AAA,59,41,26,100,14,0,14,0.14,1.0,0.14,1,0
594986,Kyle Ryan,2022,AAA,39,23,30,62,3,0,3,0.0483870967741935,1.0,0.0483870967741935,1,0
595191,Jerad Eickhoff,2022,AAA,54,33,24,87,22,0,22,0.2528735632183908,1.0,0.2528735632183908,1,0
595411,Ryan Sherriff,2022,AAA,9,7,10,16,1,1,2,0.125,0.5,0.0625,1,0
595465,Dan Winkler,2022,AAA,32,16,29,48,6,0,6,0.125,1.0,0.125,1,0
595798,R.J. Alaniz,2022,AAA,12,7,10,19,7,0,7,0.3684210526315789,1.0,0.3684210526315789,1,0
595893,Bryan Brickhouse,2022,AAA,10,8,6,18,0,0,0,0.0,,0.0,1,0
595988,Heath Holder,2022,AAA,27,17,19,44,0,2,2,0.0454545454545454,0.0,0.0,1,0
596001,Jakob Junis,2022,AAA,7,6,3,13,1,0,1,0.0769230769230769,1.0,0.0769230769230769,1,0
596027,Dillon Maples,2022,AAA,14,7,13,21,3,0,3,0.1428571428571428,1.0,0.1428571428571428,1,0
596035,Reggie McClain,2022,AAA,20,12,16,32,6,0,6,0.1875,1.0,0.1875,1,0
596043,Daniel Mengden,2022,AAA,80,27,24,107,5,1,6,0.0560747663551401,0.8333333333333334,0.0467289719626168,1,0
596082,Jake Reed,2022,AAA,16,6,12,22,6,0,6,0.2727272727272727,1.0,0.2727272727272727,1,0
596271,Casey Lawrence,2022,AAA,47,28,21,75,9,2,11,0.1466666666666666,0.8181818181818182,0.12,1,0
598286,Nick Ramirez,2022,AAA,27,20,29,47,3,0,3,0.0638297872340425,1.0,0.0638297872340425,1,0
600355,Tyler Herb,2022,AAA,66,34,20,100,7,2,9,0.09,0.7777777777777778,0.07,1,0
600853,Jose Adames,2022,AAA,24,11,14,35,4,1,5,0.1428571428571428,0.8,0.1142857142857142,1,0
600887,Miguel Del Pozo,2022,AAA,29,19,27,48,1,2,3,0.0625,0.3333333333333333,0.0208333333333333,1,0
600921,Andrés Machado,2022,AAA,10,9,10,19,2,1,3,0.1578947368421052,0.6666666666666666,0.1052631578947368,1,0
605138,Wes Benjamin,2022,AAA,21,5,7,26,0,0,0,0.0,,0.0,1,0
605155,Colten Brewer,2022,AAA,28,13,23,41,7,0,7,0.1707317073170731,1.0,0.1707317073170731,1,0
605156,Aaron Brooks,2022,AAA,40,20,13,60,1,0,1,0.0166666666666666,1.0,0.0166666666666666,1,0
605194,Jharel Cotton,2022,AAA,9,7,10,16,3,0,3,0.1875,1.0,0.1875,1,0
605232,Brandon Finnegan,2022,AAA,33,16,25,49,6,0,6,0.1224489795918367,1.0,0.1224489795918367,1,0
605240,Jace Fry,2022,AAA,31,7,23,38,3,0,3,0.0789473684210526,1.0,0.0789473684210526,1,0
605254,Daniel Gossett,2022,AAA,31,25,13,56,4,4,8,0.1428571428571428,0.5,0.0714285714285714,1,0
605276,David Hess,2022,AAA,6,6,3,12,1,0,1,0.0833333333333333,1.0,0.0833333333333333,1,0
605288,Adrian Houser,2022,AAA,6,4,3,10,1,1,2,0.2,0.5,0.1,1,0
605309,Keone Kela,2022,AAA,9,8,10,17,3,0,3,0.1764705882352941,1.0,0.1764705882352941,1,0
605335,Brandon Leibrandt,2022,AAA,27,9,9,36,6,2,8,0.2222222222222222,0.75,0.1666666666666666,1,0
605441,Yacksel Ríos,2022,AAA,31,14,25,45,2,0,2,0.0444444444444444,1.0,0.0444444444444444,1,0
605446,Dereck Rodríguez,2022,AAA,48,24,21,72,8,2,10,0.1388888888888889,0.8,0.1111111111111111,1,0
605463,Tayler Scott,2022,AAA,32,15,30,47,9,0,9,0.1914893617021276,1.0,0.1914893617021276,1,0
605525,J.B. Wendelken,2022,AAA,9,9,9,18,1,0,1,0.0555555555555555,1.0,0.0555555555555555,1,0
605541,Mike Wright Jr.,2022,AAA,43,6,17,49,2,1,3,0.0612244897959183,0.6666666666666666,0.0408163265306122,1,0
606131,Luis Perdomo,2022,AAA,14,6,11,20,4,2,6,0.3,0.6666666666666666,0.2,1,0
606162,Yefry Ramírez,2022,AAA,25,9,8,34,4,1,5,0.1470588235294117,0.8,0.1176470588235294,1,0
606273,Roenis Elías,2022,AAA,41,21,25,62,6,2,8,0.1290322580645161,0.75,0.0967741935483871,1,0
606930,Jacob Barnes,2022,AAA,9,1,9,10,2,0,2,0.2,1.0,0.2,1,0
606939,Aaron Brown,2022,AAA,44,20,35,64,10,0,10,0.15625,1.0,0.15625,1,0
606944,Cody Carroll,2022,AAA,27,20,22,47,5,0,5,0.1063829787234042,1.0,0.1063829787234042,1,0
606965,Chris Devenski,2022,AAA,9,1,9,10,4,0,4,0.4,1.0,0.4,1,0
606981,Darin Gillies,2022,AAA,11,6,6,17,0,0,0,0.0,,0.0,1,0
606996,Kyle Hart,2022,AAA,25,16,9,41,3,1,4,0.0975609756097561,0.75,0.073170731707317,1,0
607179,Jordan Weems,2022,AAA,17,9,18,26,2,0,2,0.0769230769230769,1.0,0.0769230769230769,1,0
607188,Jake Faria,2022,AAA,29,14,12,43,3,2,5,0.1162790697674418,0.6,0.0697674418604651,1,0
607215,Eric Skoglund,2022,AAA,8,2,6,10,3,1,4,0.4,0.75,0.3,1,0
607229,Robert Gsellman,2022,AAA,17,12,7,29,4,2,6,0.2068965517241379,0.6666666666666666,0.1379310344827586,1,0
607352,Joe Biagini,2022,AAA,25,18,19,43,5,1,6,0.1395348837209302,0.8333333333333334,0.1162790697674418,1,0
607359,Spencer Patton,2022,AAA,25,8,15,33,2,0,2,0.0606060606060606,1.0,0.0606060606060606,1,0
607374,Nick Tropeano,2022,AAA,10,9,10,19,1,0,1,0.0526315789473684,1.0,0.0526315789473684,1,0
607391,Chris Mazza,2022,AAA,34,19,20,53,1,1,2,0.0377358490566037,0.5,0.0188679245283018,1,0
607457,Kyle Barraclough,2022,AAA,28,17,24,45,9,1,10,0.2222222222222222,0.9,0.2,1,0
607572,Sam Howard,2022,AAA,21,8,20,29,2,1,3,0.1034482758620689,0.6666666666666666,0.0689655172413793,1,0
607755,Andrew Vasquez,2022,AAA,14,6,12,20,3,0,3,0.15,1.0,0.15,1,0
608167,Jonathan Aro,2022,AAA,43,29,28,72,4,0,4,0.0555555555555555,1.0,0.0555555555555555,1,0
608334,Carson Fulmer,2022,AAA,25,24,31,49,2,0,2,0.0408163265306122,1.0,0.0408163265306122,1,0
608638,JT Chargois,2022,AAA,5,7,6,12,0,0,0,0.0,,0.0,1,0
608648,Tyler Duffey,2022,AAA,11,5,8,16,0,0,0,0.0,,0.0,1,0
608652,Luke Farrell,2022,AAA,46,12,16,58,4,1,5,0.0862068965517241,0.8,0.0689655172413793,1,0
608716,Drew Steckenrider,2022,AAA,16,10,15,26,6,0,6,0.2307692307692307,1.0,0.2307692307692307,1,0
611093,Silvino Bracho,2022,AAA,26,10,21,36,5,2,7,0.1944444444444444,0.7142857142857143,0.1388888888888889,1,0
613317,Kyle Bird,2022,AAA,40,22,33,62,5,0,5,0.0806451612903225,1.0,0.0806451612903225,1,0
620396,Miguel Aguilar,2022,AAA,30,16,33,46,0,0,0,0.0,,0.0,1,0
620445,José Mujica,2022,AAA,27,13,23,40,13,0,13,0.325,1.0,0.325,1,0
620454,José Castillo,2022,AAA,26,18,25,44,9,0,9,0.2045454545454545,1.0,0.2045454545454545,1,0
620982,Ricardo Pinto,2022,AAA,27,14,16,41,2,1,3,0.073170731707317,0.6666666666666666,0.048780487804878,1,0
621016,Jose Cuas,2022,AAA,21,7,13,28,0,0,0,0.0,,0.0,1,0
621053,Tyler Ferguson,2022,AAA,20,21,16,41,6,0,6,0.1463414634146341,1.0,0.1463414634146341,1,0
621056,Hunter Wood,2022,AAA,9,2,6,11,1,0,1,0.0909090909090909,1.0,0.0909090909090909,1,0
621057,Justin Garza,2022,AAA,19,9,17,28,0,1,1,0.0357142857142857,0.0,0.0,1,0
621074,Michael Rucker,2022,AAA,14,5,8,19,1,0,1,0.0526315789473684,1.0,0.0526315789473684,1,0
621076,James Kaprielian,2022,AAA,5,6,2,11,3,0,3,0.2727272727272727,1.0,0.2727272727272727,1,0
621079,Collin Wiles,2022,AAA,96,29,26,125,6,3,9,0.072,0.6666666666666666,0.048,1,0
621082,Jacob Lemoine,2022,AAA,28,15,21,43,3,1,4,0.0930232558139534,0.75,0.0697674418604651,1,0
621086,James Marvel,2022,AAA,77,35,28,112,9,1,10,0.0892857142857142,0.9,0.0803571428571428,1,0
621098,Eric Hanhold,2022,AAA,39,21,30,60,3,0,3,0.05,1.0,0.05,1,0
621121,Lance McCullers Jr.,2022,AAA,7,4,3,11,1,0,1,0.0909090909090909,1.0,0.0909090909090909,1,0
621129,Kyle Cody,2022,AAA,16,6,8,22,1,0,1,0.0454545454545454,1.0,0.0454545454545454,1,0
621142,Ty Buttrey,2022,AAA,26,16,21,42,4,0,4,0.0952380952380952,1.0,0.0952380952380952,1,0
621219,Alec Mills,2022,AAA,7,5,4,12,0,0,0,0.0,,0.0,1,0
621248,Ralph Garza Jr.,2022,AAA,23,9,12,32,2,0,2,0.0625,1.0,0.0625,1,0
621259,Brody Koerner,2022,AAA,16,17,9,33,2,0,2,0.0606060606060606,1.0,0.0606060606060606,1,0
621261,Corey Oswalt,2022,AAA,37,23,21,60,7,2,9,0.15,0.7777777777777778,0.1166666666666666,1,0
621348,Sam Clay,2022,AAA,28,19,27,47,1,1,2,0.0425531914893617,0.5,0.0212765957446808,1,0
621383,Tanner Banks,2022,AAA,12,6,7,18,1,1,2,0.1111111111111111,0.5,0.0555555555555555,1,0
621389,Ty Blach,2022,AAA,31,11,14,42,2,0,2,0.0476190476190476,1.0,0.0476190476190476,1,0
621403,Nathan Kirby,2022,AAA,30,19,15,49,7,1,8,0.1632653061224489,0.875,0.1428571428571428,1,0
621593,Anthony Castro,2022,AAA,40,16,27,56,4,0,4,0.0714285714285714,1.0,0.0714285714285714,1,0
622065,Alex Young,2022,AAA,20,7,18,27,2,0,2,0.074074074074074,1.0,0.074074074074074,1,0
622092,Kyle Zimmer,2022,AAA,36,14,22,50,5,2,7,0.14,0.7142857142857143,0.1,1,0
622103,Gerardo Reyes,2022,AAA,33,13,32,46,1,0,1,0.0217391304347826,1.0,0.0217391304347826,1,0
622250,Josh Sborz,2022,AAA,8,9,10,17,2,1,3,0.1764705882352941,0.6666666666666666,0.1176470588235294,1,0
622256,Patrick Weigel,2022,AAA,44,24,38,68,6,1,7,0.1029411764705882,0.8571428571428571,0.088235294117647,1,0
622338,Jesús Liranzo,2022,AAA,16,4,12,20,5,0,5,0.25,1.0,0.25,1,0
622379,Luis F. Castillo,2022,AAA,25,11,22,36,0,0,0,0.0,,0.0,1,0
622415,Anthony Vizcaya,2022,AAA,14,4,9,18,0,0,0,0.0,,0.0,1,0
622446,Jefry Rodriguez,2022,AAA,48,28,22,76,13,0,13,0.1710526315789473,1.0,0.1710526315789473,1,0
622491,Luis Castillo,2022,AAA,7,3,2,10,4,1,5,0.5,0.8,0.4,1,0
622608,Antonio Senzatela,2022,AAA,9,2,2,11,0,0,0,0.0,,0.0,1,0
622694,Elieser Hernández,2022,AAA,26,15,12,41,1,2,3,0.073170731707317,0.3333333333333333,0.024390243902439,1,0
622766,Miguel Díaz,2022,AAA,42,25,34,67,3,1,4,0.0597014925373134,0.75,0.044776119402985,1,0
622772,Jimmy Cordero,2022,AAA,21,11,21,32,3,0,3,0.09375,1.0,0.09375,1,0
622780,Angel Perdomo,2022,AAA,16,7,13,23,6,0,6,0.2608695652173913,1.0,0.2608695652173913,1,0
622786,Jesus Tinoco,2022,AAA,29,9,20,38,5,0,5,0.131578947368421,1.0,0.131578947368421,1,0
622797,Pedro Payano,2022,AAA,35,24,35,59,4,0,4,0.0677966101694915,1.0,0.0677966101694915,1,0
623211,Huascar Brazobán,2022,AAA,19,7,15,26,8,1,9,0.3461538461538461,0.8888888888888888,0.3076923076923077,1,0
623354,Daniel Zamora,2022,AAA,40,22,35,62,0,0,0,0.0,,0.0,1,0
623381,Thomas Pannone,2022,AAA,27,19,13,46,5,0,5,0.108695652173913,1.0,0.108695652173913,1,0
623433,Nick Anderson,2022,AAA,17,7,10,24,0,0,0,0.0,,0.0,1,0
623437,Justin Topa,2022,AAA,14,10,13,24,7,0,7,0.2916666666666667,1.0,0.2916666666666667,1,0
623470,Jake Newberry,2022,AAA,13,7,12,20,1,0,1,0.05,1.0,0.05,1,0
623471,Justin Dillon,2022,AAA,14,11,11,25,3,0,3,0.12,1.0,0.12,1,0
623485,Ashton Goudeau,2022,AAA,54,38,18,92,17,0,17,0.1847826086956521,1.0,0.1847826086956521,1,0
624418,Ryan Castellani,2022,AAA,33,28,26,61,5,1,6,0.0983606557377049,0.8333333333333334,0.081967213114754,1,0
624427,Stephen Gonsalves,2022,AAA,10,5,8,15,2,0,2,0.1333333333333333,1.0,0.1333333333333333,1,0
624519,Logan Shore,2022,AAA,36,30,22,66,5,0,5,0.0757575757575757,1.0,0.0757575757575757,1,0
624526,Garrett Williams,2022,AAA,43,20,16,63,1,0,1,0.0158730158730158,1.0,0.0158730158730158,1,0
624647,Victor González,2022,AAA,7,4,8,11,0,0,0,0.0,,0.0,1,0
627893,Carlos Belen,2022,AAA,7,7,7,14,0,0,0,0.0,,0.0,1,0
628708,Yunior Marte,2022,AAA,8,3,7,11,2,0,2,0.1818181818181818,1.0,0.1818181818181818,1,0
628709,Ofreidy Gómez,2022,AAA,23,11,17,34,6,0,6,0.1764705882352941,1.0,0.1764705882352941,1,0
629498,Johan Quezada,2022,AAA,20,18,13,38,2,1,3,0.0789473684210526,0.6666666666666666,0.0526315789473684,1,0
630023,Yonny Chirinos,2022,AAA,9,3,5,12,0,0,0,0.0,,0.0,1,0
640454,Matt Krook,2022,AAA,82,41,28,123,21,1,22,0.1788617886178861,0.9545454545454546,0.1707317073170731,1,0
640470,Adbert Alzolay,2022,AAA,7,3,4,10,5,0,5,0.5,1.0,0.5,1,0
641312,Shaun Anderson,2022,AAA,53,27,24,80,2,1,3,0.0375,0.6666666666666666,0.025,1,0
641341,Tyler Bashlor,2022,AAA,4,6,4,10,2,0,2,0.2,1.0,0.2,1,0
641386,Ben Bowden,2022,AAA,28,14,30,42,2,1,3,0.0714285714285714,0.6666666666666666,0.0476190476190476,1,0
641401,Connor Brogdon,2022,AAA,6,4,6,10,4,0,4,0.4,1.0,0.4,1,0
641409,Zack Brown,2022,AAA,33,20,28,53,8,1,9,0.1698113207547169,0.8888888888888888,0.1509433962264151,1,0
641416,Hever Bueno,2022,AAA,28,19,22,47,12,0,12,0.2553191489361702,1.0,0.2553191489361702,1,0
641425,Thomas Burrows,2022,AAA,21,14,18,35,6,0,6,0.1714285714285714,1.0,0.1714285714285714,1,0
641447,Daniel Castano,2022,AAA,19,6,7,25,5,3,8,0.32,0.625,0.2,1,0
641464,Trey Cobb,2022,AAA,30,23,21,53,2,4,6,0.1132075471698113,0.3333333333333333,0.0377358490566037,1,0
641499,Ty Damron,2022,AAA,22,6,6,28,0,0,0,0.0,,0.0,1,0
641506,Adrian De Horta,2022,AAA,11,8,8,19,2,0,2,0.1052631578947368,1.0,0.1052631578947368,1,0
641538,Frank Duncan,2022,AAA,20,15,6,35,0,1,1,0.0285714285714285,0.0,0.0,1,0
641541,Jon Duplantier,2022,AAA,58,25,27,83,5,1,6,0.072289156626506,0.8333333333333334,0.0602409638554216,1,0
641551,Jake Elliott,2022,AAA,10,9,10,19,1,1,2,0.1052631578947368,0.5,0.0526315789473684,1,0
641571,Heath Fillmyer,2022,AAA,6,6,4,12,0,0,0,0.0,,0.0,1,0
641576,Bernardo Flores Jr.,2022,AAA,22,9,5,31,4,2,6,0.1935483870967742,0.6666666666666666,0.1290322580645161,1,0
641585,J.P. France,2022,AAA,58,25,28,83,7,2,9,0.108433734939759,0.7777777777777778,0.0843373493975903,1,0
641620,Brandon Gold,2022,AAA,87,38,27,125,5,3,8,0.064,0.625,0.04,1,0
641625,Jordan Gore,2022,AAA,20,12,14,32,3,1,4,0.125,0.75,0.09375,1,0
641632,Conner Greene,2022,AAA,18,14,13,32,3,0,3,0.09375,1.0,0.09375,1,0
641656,Ian Hamilton,2022,AAA,27,17,24,44,2,0,2,0.0454545454545454,1.0,0.0454545454545454,1,0
641672,Thomas Hatch,2022,AAA,66,37,25,103,11,3,14,0.1359223300970873,0.7857142857142857,0.1067961165048543,1,0
641682,Ryan Hendrix,2022,AAA,37,14,27,51,5,2,7,0.1372549019607843,0.7142857142857143,0.0980392156862745,1,0
641703,Brent Honeywell,2022,AAA,13,7,9,20,5,0,5,0.25,1.0,0.25,1,0
641709,Brian Howard,2022,AAA,45,22,33,67,7,2,9,0.1343283582089552,0.7777777777777778,0.1044776119402985,1,0
641712,Dakota Hudson,2022,AAA,17,5,3,22,1,1,2,0.0909090909090909,0.5,0.0454545454545454,1,0
641733,Connor Johnstone,2022,AAA,42,23,23,65,1,0,1,0.0153846153846153,1.0,0.0153846153846153,1,0
641743,Anthony Kay,2022,AAA,9,8,6,17,5,0,5,0.2941176470588235,1.0,0.2941176470588235,1,0
641853,David McKay,2022,AAA,19,11,17,30,3,0,3,0.1,1.0,0.1,1,0
641855,Ian McKinney,2022,AAA,22,13,9,35,1,0,1,0.0285714285714285,1.0,0.0285714285714285,1,0
641871,Keynan Middleton,2022,AAA,8,3,10,11,4,0,4,0.3636363636363636,1.0,0.3636363636363636,1,0
641886,Andrew Mitchell,2022,AAA,11,7,8,18,3,0,3,0.1666666666666666,1.0,0.1666666666666666,1,0
641889,Dalton Moats,2022,AAA,24,13,25,37,4,1,5,0.1351351351351351,0.8,0.1081081081081081,1,0
641907,Patrick Murphy,2022,AAA,40,20,24,60,1,0,1,0.0166666666666666,1.0,0.0166666666666666,1,0
641949,John Parke,2022,AAA,114,48,28,162,6,1,7,0.0432098765432098,0.8571428571428571,0.037037037037037,1,0
641962,CD Pelham,2022,AAA,8,2,7,10,3,0,3,0.3,1.0,0.3,1,0
641978,Matt Pidich,2022,AAA,27,17,23,44,6,0,6,0.1363636363636363,1.0,0.1363636363636363,1,0
641995,Roel Ramírez,2022,AAA,22,6,15,28,2,1,3,0.1071428571428571,0.6666666666666666,0.0714285714285714,1,0
642016,Daniel Robert,2022,AAA,24,14,21,38,7,1,8,0.2105263157894736,0.875,0.1842105263157894,1,0
642028,Josh Rogers,2022,AAA,47,16,12,63,2,2,4,0.0634920634920634,0.5,0.0317460317460317,1,0
642048,Tayler Saucedo,2022,AAA,11,4,10,15,1,0,1,0.0666666666666666,1.0,0.0666666666666666,1,0
642060,Cody Sedlock,2022,AAA,60,32,22,92,12,1,13,0.1413043478260869,0.9230769230769232,0.1304347826086956,1,0
642068,Jordan Sheffield,2022,AAA,21,6,19,27,3,1,4,0.1481481481481481,0.75,0.1111111111111111,1,0
642092,Riley Smith,2022,AAA,73,44,19,117,14,1,15,0.1282051282051282,0.9333333333333332,0.1196581196581196,1,0
642100,Gabe Speier,2022,AAA,24,17,20,41,6,0,6,0.1463414634146341,1.0,0.1463414634146341,1,0
642130,Blake Taylor,2022,AAA,11,2,7,13,1,0,1,0.0769230769230769,1.0,0.0769230769230769,1,0
642141,Jake Thompson,2022,AAA,16,14,12,30,5,1,6,0.2,0.8333333333333334,0.1666666666666666,1,0
642177,Matt Vogel,2022,AAA,21,14,16,35,5,0,5,0.1428571428571428,1.0,0.1428571428571428,1,0
642203,Taylor Widener,2022,AAA,18,14,18,32,8,1,9,0.28125,0.8888888888888888,0.25,1,0
642216,Allan Winans,2022,AAA,8,5,4,13,3,0,3,0.2307692307692307,1.0,0.2307692307692307,1,0
642231,Jimmy Yacabonis,2022,AAA,19,13,15,32,5,0,5,0.15625,1.0,0.15625,1,0
642232,Ryan Yarbrough,2022,AAA,17,12,6,29,4,0,4,0.1379310344827586,1.0,0.1379310344827586,1,0
642233,Eric Yardley,2022,AAA,41,25,26,66,10,1,11,0.1666666666666666,0.9090909090909092,0.1515151515151515,1,0
642236,Joe Zanghi,2022,AAA,14,11,10,25,2,0,2,0.08,1.0,0.08,1,0
642239,Rob Zastryzny,2022,AAA,39,14,22,53,5,1,6,0.1132075471698113,0.8333333333333334,0.0943396226415094,1,0
642271,Fernery Ozuna,2022,AAA,20,10,11,30,3,2,5,0.1666666666666666,0.6,0.1,1,0
642496,Emilio Vargas,2022,AAA,23,12,8,35,4,0,4,0.1142857142857142,1.0,0.1142857142857142,1,0
642513,Julio Pinto,2022,AAA,14,11,13,25,2,0,2,0.08,1.0,0.08,1,0
642530,Luis Reyes,2022,AAA,13,11,5,24,2,0,2,0.0833333333333333,1.0,0.0833333333333333,1,0
642546,Jonathan Hernández,2022,AAA,12,5,11,17,2,0,2,0.1176470588235294,1.0,0.1176470588235294,1,0
642558,Ariel Jurado,2022,AAA,26,10,12,36,1,1,2,0.0555555555555555,0.5,0.0277777777777777,1,0
642578,José Rodríguez,2022,AAA,55,26,27,81,4,1,5,0.0617283950617283,0.8,0.0493827160493827,1,0
642584,Franklyn Kilome,2022,AAA,36,23,11,59,10,0,10,0.1694915254237288,1.0,0.1694915254237288,1,0
642657,Cristofer Ogando,2022,AAA,34,9,25,43,8,0,8,0.1860465116279069,1.0,0.1860465116279069,1,0
642659,Raynel Espinal,2022,AAA,69,32,27,101,17,5,22,0.2178217821782178,0.7727272727272727,0.1683168316831683,1,0
642759,Julian Fernández,2022,AAA,34,24,34,58,13,2,15,0.2586206896551724,0.8666666666666667,0.2241379310344827,1,0
642770,Javy Guerra,2022,AAA,18,13,23,31,3,1,4,0.1290322580645161,0.75,0.0967741935483871,1,0
642834,Jonathan Bermúdez,2022,AAA,51,33,22,84,3,0,3,0.0357142857142857,1.0,0.0357142857142857,1,0
643232,Matt Brill,2022,AAA,28,16,22,44,3,0,3,0.0681818181818181,1.0,0.0681818181818181,1,0
643239,Parker Bugg,2022,AAA,20,10,17,30,3,3,6,0.2,0.5,0.1,1,0
643290,Justin Dunn,2022,AAA,21,11,7,32,11,0,11,0.34375,1.0,0.34375,1,0
643316,Paul Fry,2022,AAA,19,9,18,28,2,0,2,0.0714285714285714,1.0,0.0714285714285714,1,0
643327,Zack Godley,2022,AAA,23,12,13,35,4,1,5,0.1428571428571428,0.8,0.1142857142857142,1,0
643361,Kevin Herget,2022,AAA,53,18,19,71,6,4,10,0.1408450704225352,0.6,0.0845070422535211,1,0
643400,Dusten Knight,2022,AAA,33,15,27,48,4,1,5,0.1041666666666666,0.8,0.0833333333333333,1,0
643410,Mark Leiter Jr.,2022,AAA,18,10,6,28,5,0,5,0.1785714285714285,1.0,0.1785714285714285,1,0
643493,Austin Pruitt,2022,AAA,12,9,9,21,2,0,2,0.0952380952380952,1.0,0.0952380952380952,1,0
643532,Sterling Sharp,2022,AAA,55,32,18,87,6,3,9,0.1034482758620689,0.6666666666666666,0.0689655172413793,1,0
643539,Caleb Simpson,2022,AAA,22,13,16,35,2,0,2,0.0571428571428571,1.0,0.0571428571428571,1,0
643588,Tyler Viza,2022,AAA,13,12,12,25,0,0,0,0.0,,0.0,1,0
643615,T.J. Zeuch,2022,AAA,36,16,10,52,8,3,11,0.2115384615384615,0.7272727272727273,0.1538461538461538,1,0
644396,Luis Ledo,2022,AAA,8,2,5,10,0,2,2,0.2,0.0,0.0,1,0
644429,Anderson Severino,2022,AAA,31,13,25,44,1,0,1,0.0227272727272727,1.0,0.0227272727272727,1,0
645307,Ricardo Sánchez,2022,AAA,91,40,25,131,10,1,11,0.0839694656488549,0.9090909090909092,0.0763358778625954,1,0
646241,Enmanuel De Jesus,2022,AAA,79,38,33,117,6,4,10,0.0854700854700854,0.6,0.0512820512820512,1,0
646242,Jhonathan Díaz,2022,AAA,27,14,10,41,3,1,4,0.0975609756097561,0.75,0.073170731707317,1,0
646243,Yoan Aybar,2022,AAA,24,9,23,33,8,0,8,0.2424242424242424,1.0,0.2424242424242424,1,0
647315,Zach Pop,2022,AAA,14,12,12,26,2,1,3,0.1153846153846153,0.6666666666666666,0.0769230769230769,1,0
647336,Michael Soroka,2022,AAA,13,10,4,23,4,0,4,0.1739130434782608,1.0,0.1739130434782608,1,0
650204,Norge Ruiz,2022,AAA,21,11,18,32,3,0,3,0.09375,1.0,0.09375,1,0
650378,Ofelky Peralta,2022,AAA,20,12,9,32,2,1,3,0.09375,0.6666666666666666,0.0625,1,0
650382,Darwinzon Hernández,2022,AAA,26,13,19,39,6,0,6,0.1538461538461538,1.0,0.1538461538461538,1,0
650496,J.C. Mejía,2022,AAA,11,7,12,18,3,0,3,0.1666666666666666,1.0,0.1666666666666666,1,0
650530,Bryan Garcia,2022,AAA,52,29,26,81,6,2,8,0.0987654320987654,0.75,0.074074074074074,1,0
650644,Aaron Civale,2022,AAA,6,6,4,12,5,0,5,0.4166666666666667,1.0,0.4166666666666667,1,0
650654,Cristopher Molina,2022,AAA,11,8,4,19,4,1,5,0.2631578947368421,0.8,0.2105263157894736,1,0
650668,Humberto Mejía,2022,AAA,11,7,6,18,0,0,0,0.0,,0.0,1,0
650841,Diomar Lopez,2022,AAA,9,7,5,16,1,0,1,0.0625,1.0,0.0625,1,0
650893,Génesis Cabrera,2022,AAA,9,7,4,16,2,0,2,0.125,1.0,0.125,1,0
650911,Cristopher Sánchez,2022,AAA,38,15,15,53,5,4,9,0.1698113207547169,0.5555555555555556,0.0943396226415094,1,0
650959,Marcos Diplán,2022,AAA,15,7,11,22,0,0,0,0.0,,0.0,1,0
656008,Aneurys Zabala,2022,AAA,24,15,15,39,12,0,12,0.3076923076923077,1.0,0.3076923076923077,1,0
656080,Aneuris Rosario,2022,AAA,20,15,17,35,6,1,7,0.2,0.8571428571428571,0.1714285714285714,1,0
656083,Harol González,2022,AAA,22,6,8,28,2,0,2,0.0714285714285714,1.0,0.0714285714285714,1,0
656206,Jeff Bain,2022,AAA,8,3,6,11,0,0,0,0.0,,0.0,1,0
656232,Brandon Bielak,2022,AAA,57,26,22,83,12,1,13,0.1566265060240964,0.9230769230769232,0.144578313253012,1,0
656234,Jake Bird,2022,AAA,16,4,13,20,3,0,3,0.15,1.0,0.15,1,0
656240,Scott Blewett,2022,AAA,13,6,3,19,1,0,1,0.0526315789473684,1.0,0.0526315789473684,1,0
656257,Jeff Brigham,2022,AAA,21,13,20,34,8,0,8,0.2352941176470588,1.0,0.2352941176470588,1,0
656259,Jordan Brink,2022,AAA,13,17,15,30,3,0,3,0.1,1.0,0.1,1,0
656266,J.B. Bukauskas,2022,AAA,12,6,10,18,1,1,2,0.1111111111111111,0.5,0.0555555555555555,1,0
656290,Drew Carlton,2022,AAA,37,18,28,55,2,0,2,0.0363636363636363,1.0,0.0363636363636363,1,0
656322,Sam Coonrod,2022,AAA,7,6,7,13,1,0,1,0.0769230769230769,1.0,0.0769230769230769,1,0
656349,Brett Daniels,2022,AAA,9,7,8,16,0,0,0,0.0,,0.0,1,0
656353,Tucker Davidson,2022,AAA,41,21,14,62,11,1,12,0.1935483870967742,0.9166666666666666,0.1774193548387097,1,0
656427,Jack Flaherty,2022,AAA,7,3,2,10,0,0,0,0.0,,0.0,1,0
656450,Joe Gatto,2022,AAA,31,23,21,54,6,0,6,0.1111111111111111,1.0,0.1111111111111111,1,0
656457,Tyler Gilbert,2022,AAA,20,19,11,39,5,2,7,0.1794871794871795,0.7142857142857143,0.1282051282051282,1,0
656464,Kevin Ginkel,2022,AAA,19,6,16,25,2,0,2,0.08,1.0,0.08,1,0
656492,Foster Griffin,2022,AAA,21,14,23,35,3,1,4,0.1142857142857142,0.75,0.0857142857142857,1,0
656544,Colton Hock,2022,AAA,13,9,8,22,4,1,5,0.2272727272727272,0.8,0.1818181818181818,1,0
656547,Jonathan Holder,2022,AAA,17,12,10,29,8,0,8,0.2758620689655172,1.0,0.2758620689655172,1,0
656548,Jordan Holloway,2022,AAA,14,2,6,16,4,2,6,0.375,0.6666666666666666,0.25,1,0
656550,Grant Holmes,2022,AAA,34,18,23,52,2,0,2,0.0384615384615384,1.0,0.0384615384615384,1,0
656561,Nick Howard,2022,AAA,19,19,12,38,2,0,2,0.0526315789473684,1.0,0.0526315789473684,1,0
656578,Andre Jackson,2022,AAA,61,36,20,97,12,5,17,0.1752577319587628,0.7058823529411765,0.1237113402061855,1,0
656592,Tyler Johnson,2022,AAA,6,5,5,11,2,0,2,0.1818181818181818,1.0,0.1818181818181818,1,0
656594,Kyle Johnston,2022,AAA,55,32,41,87,2,0,2,0.0229885057471264,1.0,0.0229885057471264,1,0
656620,Gabe Klobosits,2022,AAA,8,5,5,13,2,0,2,0.1538461538461538,1.0,0.1538461538461538,1,0
656641,Jacob Latz,2022,AAA,40,14,17,54,9,0,9,0.1666666666666666,1.0,0.1666666666666666,1,0
656657,Zach Logue,2022,AAA,69,44,17,113,17,4,21,0.1858407079646017,0.8095238095238095,0.1504424778761062,1,0
656686,Corbin Martin,2022,AAA,53,17,16,70,4,3,7,0.1,0.5714285714285714,0.0571428571428571,1,0
656701,Kade McClure,2022,AAA,47,21,30,68,3,0,3,0.0441176470588235,1.0,0.0441176470588235,1,0
656727,Kodi Medeiros,2022,AAA,8,6,7,14,4,0,4,0.2857142857142857,1.0,0.2857142857142857,1,0
656730,Trevor Megill,2022,AAA,8,4,6,12,0,0,0,0.0,,0.0,1,0
656755,Bryce Montes de Oca,2022,AAA,30,15,23,45,12,0,12,0.2666666666666666,1.0,0.2666666666666666,1,0
656786,Parker Mushinski,2022,AAA,22,10,21,32,2,0,2,0.0625,1.0,0.0625,1,0
656794,Sean Newcomb,2022,AAA,14,8,11,22,6,0,6,0.2727272727272727,1.0,0.2727272727272727,1,0
656803,James Norwood,2022,AAA,16,8,11,24,2,0,2,0.0833333333333333,1.0,0.0833333333333333,1,0
656804,Andrés Núñez,2022,AAA,51,18,36,69,5,1,6,0.0869565217391304,0.8333333333333334,0.072463768115942,1,0
656814,Luis F. Ortiz,2022,AAA,38,21,28,59,3,2,5,0.0847457627118644,0.6,0.0508474576271186,1,0
656818,Connor Overton,2022,AAA,10,4,6,14,4,1,5,0.3571428571428571,0.8,0.2857142857142857,1,0
656820,Nicholas Padilla,2022,AAA,12,4,10,16,1,0,1,0.0625,1.0,0.0625,1,0
656849,David Peterson,2022,AAA,20,9,6,29,3,1,4,0.1379310344827586,0.75,0.1034482758620689,1,0
656924,Ryder Ryan,2022,AAA,36,25,34,61,8,0,8,0.1311475409836065,1.0,0.1311475409836065,1,0
656954,Justus Sheffield,2022,AAA,89,51,24,140,17,1,18,0.1285714285714285,0.9444444444444444,0.1214285714285714,1,0
656970,Devin Smeltzer,2022,AAA,25,21,14,46,3,0,3,0.0652173913043478,1.0,0.0652173913043478,1,0
656981,Peter Solomon,2022,AAA,74,36,27,110,6,1,7,0.0636363636363636,0.8571428571428571,0.0545454545454545,1,0
656986,Bennett Sousa,2022,AAA,16,5,11,21,1,1,2,0.0952380952380952,0.5,0.0476190476190476,1,0
657047,Reagan Todd,2022,AAA,32,20,31,52,5,0,5,0.0961538461538461,1.0,0.0961538461538461,1,0
657053,Touki Toussaint,2022,AAA,43,18,19,61,5,0,5,0.081967213114754,1.0,0.081967213114754,1,0
657092,Zach Warren,2022,AAA,22,13,17,35,5,0,5,0.1428571428571428,1.0,0.1428571428571428,1,0
657097,Jacob Webb,2022,AAA,15,10,15,25,3,0,3,0.12,1.0,0.12,1,0
657116,Zach Willeman,2022,AAA,31,15,25,46,2,2,4,0.0869565217391304,0.5,0.0434782608695652,1,0
657122,Ronnie Williams,2022,AAA,29,13,9,42,3,1,4,0.0952380952380952,0.75,0.0714285714285714,1,0
657141,Jordan Yamamoto,2022,AAA,18,8,6,26,2,0,2,0.0769230769230769,1.0,0.0769230769230769,1,0
657203,Will Carter,2022,AAA,27,15,21,42,3,2,5,0.119047619047619,0.6,0.0714285714285714,1,0
657228,Jake Jewell,2022,AAA,33,26,30,59,9,0,9,0.1525423728813559,1.0,0.1525423728813559,1,0
657265,Peter Strzelecki,2022,AAA,13,5,10,18,3,1,4,0.2222222222222222,0.75,0.1666666666666666,1,0
657272,Erich Uelmen,2022,AAA,28,13,22,41,2,2,4,0.0975609756097561,0.5,0.048780487804878,1,0
657376,Clarke Schmidt,2022,AAA,19,9,7,28,10,0,10,0.3571428571428571,1.0,0.3571428571428571,1,0
657424,Matt Gage,2022,AAA,26,11,20,37,5,0,5,0.1351351351351351,1.0,0.1351351351351351,1,0
657508,Mike Baumann,2022,AAA,38,16,17,54,6,1,7,0.1296296296296296,0.8571428571428571,0.1111111111111111,1,0
657514,Brennan Bernardino,2022,AAA,13,7,11,20,1,0,1,0.05,1.0,0.05,1,0
657581,Will Gaddis,2022,AAA,10,5,5,15,1,0,1,0.0666666666666666,1.0,0.0666666666666666,1,0
657585,Reed Garrett,2022,AAA,21,16,23,37,3,0,3,0.081081081081081,1.0,0.081081081081081,1,0
657624,Josh James,2022,AAA,16,11,16,27,4,0,4,0.1481481481481481,1.0,0.1481481481481481,1,0
657649,Jared Koenig,2022,AAA,47,39,19,86,2,1,3,0.0348837209302325,0.6666666666666666,0.0232558139534883,1,0
657697,Vinny Nittoli,2022,AAA,26,10,22,36,5,2,7,0.1944444444444444,0.7142857142857143,0.1388888888888889,1,0
657744,Keith Rogalla,2022,AAA,22,12,17,34,2,0,2,0.0588235294117647,1.0,0.0588235294117647,1,0
657745,Bubby Rossman,2022,AAA,22,11,10,33,5,1,6,0.1818181818181818,0.8333333333333334,0.1515151515151515,1,0
657756,Connor Seabold,2022,AAA,43,22,17,65,2,1,3,0.0461538461538461,0.6666666666666666,0.0307692307692307,1,0
657766,Locke St. John,2022,AAA,33,19,26,52,1,0,1,0.0192307692307692,1.0,0.0192307692307692,1,0
657770,Eric Stout,2022,AAA,24,7,16,31,1,0,1,0.032258064516129,1.0,0.032258064516129,1,0
658431,Adonis Medina,2022,AAA,24,13,16,37,5,1,6,0.1621621621621621,0.8333333333333334,0.1351351351351351,1,0
658551,Junior Fernández,2022,AAA,41,19,26,60,0,0,0,0.0,,0.0,1,0
658648,Pedro Avila,2022,AAA,61,34,29,95,8,2,10,0.1052631578947368,0.8,0.0842105263157894,1,0
658667,Cristofer Melendez,2022,AAA,23,9,17,32,0,0,0,0.0,,0.0,1,0
658742,Diogenes Almengo,2022,AAA,18,5,13,23,4,1,5,0.217391304347826,0.8,0.1739130434782608,1,0
658791,Wei-Chieh Huang,2022,AAA,38,21,19,59,6,1,7,0.1186440677966101,0.8571428571428571,0.1016949152542373,1,0
659262,Anderson Espinoza,2022,AAA,18,9,8,27,5,0,5,0.1851851851851851,1.0,0.1851851851851851,1,0
659275,Dinelson Lamet,2022,AAA,6,7,8,13,0,0,0,0.0,,0.0,1,0
659418,Noah Skirrow,2022,AAA,9,3,3,12,0,0,0,0.0,,0.0,1,0
660435,Chester Pimentel,2022,AAA,7,6,6,13,1,0,1,0.0769230769230769,1.0,0.0769230769230769,1,0
660508,Norwith Gudiño,2022,AAA,27,15,19,42,2,0,2,0.0476190476190476,1.0,0.0476190476190476,1,0
660546,Yennsy Díaz,2022,AAA,19,13,16,32,4,0,4,0.125,1.0,0.125,1,0
660593,Denyi Reyes,2022,AAA,35,18,13,53,6,1,7,0.1320754716981132,0.8571428571428571,0.1132075471698113,1,0
660600,Enoli Paredes,2022,AAA,25,19,22,44,2,1,3,0.0681818181818181,0.6666666666666666,0.0454545454545454,1,0
660623,Huascar Ynoa,2022,AAA,48,24,18,72,21,1,22,0.3055555555555556,0.9545454545454546,0.2916666666666667,1,0
660730,Elvin Rodríguez,2022,AAA,55,38,22,93,0,3,3,0.032258064516129,0.0,0.0,1,0
660749,Wladimir Pinto,2022,AAA,24,14,19,38,8,0,8,0.2105263157894736,1.0,0.2105263157894736,1,0
660756,Eury Ramos,2022,AAA,12,7,9,19,4,0,4,0.2105263157894736,1.0,0.2105263157894736,1,0
660761,José Suarez,2022,AAA,6,7,4,13,0,0,0,0.0,,0.0,1,0
660787,Yerry De los Santos,2022,AAA,6,5,5,11,2,0,2,0.1818181818181818,1.0,0.1818181818181818,1,0
660825,Eduard Bazardo,2022,AAA,26,29,27,55,8,1,9,0.1636363636363636,0.8888888888888888,0.1454545454545454,1,0
660906,Francisco Pérez,2022,AAA,26,13,25,39,4,0,4,0.1025641025641025,1.0,0.1025641025641025,1,0
661255,Yoan López,2022,AAA,25,16,17,41,0,1,1,0.024390243902439,0.0,0.0,1,0
661309,Adrián Martínez,2022,AAA,51,26,18,77,14,3,17,0.2207792207792207,0.8235294117647058,0.1818181818181818,1,0
661332,Luke Westphal,2022,AAA,36,21,20,57,7,5,12,0.2105263157894736,0.5833333333333334,0.1228070175438596,1,0
661383,Oliver Ortega,2022,AAA,16,15,16,31,6,0,6,0.1935483870967742,1.0,0.1935483870967742,1,0
661440,Mauricio Llovera,2022,AAA,8,5,10,13,1,0,1,0.0769230769230769,1.0,0.0769230769230769,1,0
661526,Eli Lingos,2022,AAA,10,3,9,13,1,0,1,0.0769230769230769,1.0,0.0769230769230769,1,0
661527,Seth Martinez,2022,AAA,9,5,7,14,1,0,1,0.0714285714285714,1.0,0.0714285714285714,1,0
661563,Luis Gil,2022,AAA,13,5,6,18,3,0,3,0.1666666666666666,1.0,0.1666666666666666,1,0
662144,Brian Keller,2022,AAA,69,25,27,94,3,4,7,0.0744680851063829,0.4285714285714285,0.0319148936170212,1,0
662165,Austin Schulfer,2022,AAA,26,10,23,36,6,0,6,0.1666666666666666,1.0,0.1666666666666666,1,0
663321,Nick Hernandez,2022,AAA,29,16,26,45,1,1,2,0.0444444444444444,0.5,0.0222222222222222,1,0
663325,Kevin Smith,2022,AAA,51,22,17,73,6,2,8,0.1095890410958904,0.75,0.0821917808219178,1,0
663362,Matt Waldron,2022,AAA,56,35,16,91,5,2,7,0.0769230769230769,0.7142857142857143,0.0549450549450549,1,0
663366,Beau Burrows,2022,AAA,65,32,28,97,7,6,13,0.134020618556701,0.5384615384615384,0.0721649484536082,1,0
663372,Ryan Feltner,2022,AAA,31,14,11,45,2,3,5,0.1111111111111111,0.4,0.0444444444444444,1,0
663378,Thomas Szapucki,2022,AAA,46,20,20,66,13,2,15,0.2272727272727272,0.8666666666666667,0.1969696969696969,1,0
663385,Chad Smith,2022,AAA,20,11,16,31,4,0,4,0.1290322580645161,1.0,0.1290322580645161,1,0
663399,Brandon Waddell,2022,AAA,21,13,16,34,2,0,2,0.0588235294117647,1.0,0.0588235294117647,1,0
663423,Trent Thornton,2022,AAA,23,11,14,34,3,0,3,0.088235294117647,1.0,0.088235294117647,1,0
663436,Davis Martin,2022,AAA,32,19,11,51,1,1,2,0.0392156862745098,0.5,0.0196078431372549,1,0
663455,Konnor Pilkington,2022,AAA,35,21,13,56,5,0,5,0.0892857142857142,1.0,0.0892857142857142,1,0
663460,Kris Bubic,2022,AAA,7,3,3,10,1,0,1,0.1,1.0,0.1,1,0
663465,Kolby Allard,2022,AAA,52,17,20,69,8,3,11,0.1594202898550724,0.7272727272727273,0.1159420289855072,1,0
663467,Jason Bilous,2022,AAA,16,12,9,28,9,1,10,0.3571428571428571,0.9,0.3214285714285714,1,0
663472,Jack Perkins,2022,AAA,9,5,4,14,0,0,0,0.0,,0.0,1,0
663485,Cole Sands,2022,AAA,44,26,17,70,8,2,10,0.1428571428571428,0.8,0.1142857142857142,1,0
663489,Will Stewart,2022,AAA,63,25,24,88,0,1,1,0.0113636363636363,0.0,0.0,1,0
663510,Ben Leeper,2022,AAA,15,15,19,30,7,0,7,0.2333333333333333,1.0,0.2333333333333333,1,0
663531,Logan Allen,2022,AAA,43,21,21,64,1,2,3,0.046875,0.3333333333333333,0.015625,1,0
663542,Bryan Hudson,2022,AAA,29,20,22,49,4,0,4,0.0816326530612244,1.0,0.0816326530612244,1,0
663546,Sean Hjelle,2022,AAA,82,32,22,114,4,2,6,0.0526315789473684,0.6666666666666666,0.0350877192982456,1,0
663558,Jovani Morán,2022,AAA,19,11,15,30,4,0,4,0.1333333333333333,1.0,0.1333333333333333,1,0
663559,Bailey Falter,2022,AAA,10,8,8,18,1,0,1,0.0555555555555555,1.0,0.0555555555555555,1,0
663567,Peter Lambert,2022,AAA,8,4,4,12,1,1,2,0.1666666666666666,0.5,0.0833333333333333,1,0
663629,Ethan Small,2022,AAA,67,31,24,98,12,2,14,0.1428571428571428,0.8571428571428571,0.1224489795918367,1,0
663671,Nic Enright,2022,AAA,10,8,12,18,1,0,1,0.0555555555555555,1.0,0.0555555555555555,1,0
663678,Colton Eastman,2022,AAA,41,19,16,60,11,1,12,0.2,0.9166666666666666,0.1833333333333333,1,0
663687,Hogan Harris,2022,AAA,15,8,8,23,1,0,1,0.0434782608695652,1.0,0.0434782608695652,1,0
663734,Nick Neidert,2022,AAA,17,8,11,25,2,2,4,0.16,0.5,0.08,1,0
663753,Reiss Knehr,2022,AAA,58,25,27,83,10,2,12,0.144578313253012,0.8333333333333334,0.1204819277108433,1,0
663765,Jake Woodford,2022,AAA,28,12,11,40,3,1,4,0.1,0.75,0.075,1,0
663767,Chase Shugart,2022,AAA,23,16,14,39,1,0,1,0.0256410256410256,1.0,0.0256410256410256,1,0
663770,Demarcus Evans,2022,AAA,20,8,17,28,4,0,4,0.1428571428571428,1.0,0.1428571428571428,1,0
663773,Bryan Hoeing,2022,AAA,64,25,18,89,3,0,3,0.0337078651685393,1.0,0.0337078651685393,1,0
663793,Dakota Chalmers,2022,AAA,12,8,8,20,3,1,4,0.2,0.75,0.15,1,0
663795,Justin Hagenman,2022,AAA,33,17,25,50,2,1,3,0.06,0.6666666666666666,0.04,1,0
663804,Jackson Kowar,2022,AAA,60,27,18,87,13,1,14,0.160919540229885,0.9285714285714286,0.1494252873563218,1,0
663856,Mack Lemieux,2022,AAA,14,10,15,24,4,0,4,0.1666666666666666,1.0,0.1666666666666666,1,0
663878,Nate Pearson,2022,AAA,5,6,6,11,7,1,8,0.7272727272727273,0.875,0.6363636363636364,1,0
663884,Nolan Kingham,2022,AAA,50,20,21,70,6,0,6,0.0857142857142857,1.0,0.0857142857142857,1,0
663893,Brendon Little,2022,AAA,40,22,27,62,1,0,1,0.0161290322580645,1.0,0.0161290322580645,1,0
663941,Tristan Beck,2022,AAA,52,29,20,81,3,1,4,0.0493827160493827,0.75,0.037037037037037,1,0
663943,Nick Kennedy,2022,AAA,44,29,30,73,2,1,3,0.0410958904109589,0.6666666666666666,0.0273972602739726,1,0
663947,Tyler Holton,2022,AAA,36,5,17,41,2,1,3,0.073170731707317,0.6666666666666666,0.048780487804878,1,0
663959,Tyler Ivey,2022,AAA,11,6,5,17,2,0,2,0.1176470588235294,1.0,0.1176470588235294,1,0
663975,Nick Duron,2022,AAA,41,14,32,55,9,1,10,0.1818181818181818,0.9,0.1636363636363636,1,0
663989,Nick Vespi,2022,AAA,11,3,11,14,1,1,2,0.1428571428571428,0.5,0.0714285714285714,1,0
664006,Joey Marciano,2022,AAA,47,28,38,75,10,1,11,0.1466666666666666,0.9090909090909092,0.1333333333333333,1,0
664042,Travis Lakins Sr.,2022,AAA,13,5,5,18,3,0,3,0.1666666666666666,1.0,0.1666666666666666,1,0
664045,Thomas Eshelman,2022,AAA,25,22,13,47,3,1,4,0.0851063829787234,0.75,0.0638297872340425,1,0
664069,Ben Braymer,2022,AAA,21,11,11,32,3,0,3,0.09375,1.0,0.09375,1,0
664076,Garrett Cleavinger,2022,AAA,18,9,16,27,6,0,6,0.2222222222222222,1.0,0.2222222222222222,1,0
664092,Sean Poppen,2022,AAA,21,14,19,35,1,0,1,0.0285714285714285,1.0,0.0285714285714285,1,0
664114,Cole Uvila,2022,AAA,30,21,23,51,5,0,5,0.0980392156862745,1.0,0.0980392156862745,1,0
664116,Zack Erwin,2022,AAA,29,13,19,42,3,1,4,0.0952380952380952,0.75,0.0714285714285714,1,0
664129,Geoff Hartlieb,2022,AAA,43,20,29,63,6,0,6,0.0952380952380952,1.0,0.0952380952380952,1,0
664139,Ian Gibaut,2022,AAA,13,11,14,24,2,0,2,0.0833333333333333,1.0,0.0833333333333333,1,0
664144,Jon Olczak,2022,AAA,34,23,30,57,9,0,9,0.1578947368421052,1.0,0.1578947368421052,1,0
664155,Nate Griep,2022,AAA,27,10,23,37,0,1,1,0.027027027027027,0.0,0.0,1,0
664157,Travis Bergen,2022,AAA,21,13,19,34,1,0,1,0.0294117647058823,1.0,0.0294117647058823,1,0
664158,Matt Eckelman,2022,AAA,26,16,21,42,2,0,2,0.0476190476190476,1.0,0.0476190476190476,1,0
664161,Matt Swarmer,2022,AAA,51,22,19,73,9,0,9,0.1232876712328767,1.0,0.1232876712328767,1,0
664202,Tyler Cyr,2022,AAA,26,17,22,43,6,0,6,0.1395348837209302,1.0,0.1395348837209302,1,0
664236,Matthew Kent,2022,AAA,115,53,28,168,6,3,9,0.0535714285714285,0.6666666666666666,0.0357142857142857,1,0
664284,Carlos Espinal,2022,AAA,20,8,11,28,7,1,8,0.2857142857142857,0.875,0.25,1,0
664294,Dauri Moreta,2022,AAA,16,11,17,27,1,2,3,0.1111111111111111,0.3333333333333333,0.037037037037037,1,0
664337,Miguel Yajure,2022,AAA,37,20,15,57,8,0,8,0.1403508771929824,1.0,0.1403508771929824,1,0
664682,Ryan Meisinger,2022,AAA,13,2,11,15,2,1,3,0.2,0.6666666666666666,0.1333333333333333,1,0
664687,Durbin Feltman,2022,AAA,28,25,25,53,7,0,7,0.1320754716981132,1.0,0.1320754716981132,1,0
664776,Jake Cousins,2022,AAA,18,7,10,25,4,1,5,0.2,0.8,0.16,1,0
664849,Danny Young,2022,AAA,21,12,20,33,6,0,6,0.1818181818181818,1.0,0.1818181818181818,1,0
664871,Kyle Dowdy,2022,AAA,37,23,32,60,8,0,8,0.1333333333333333,1.0,0.1333333333333333,1,0
664875,Justin Lawrence,2022,AAA,17,6,14,23,3,0,3,0.1304347826086956,1.0,0.1304347826086956,1,0
664910,Logan Cozart,2022,AAA,26,14,18,40,4,0,4,0.1,1.0,0.1,1,0
664942,James Naile,2022,AAA,64,37,37,101,9,3,12,0.1188118811881188,0.75,0.0891089108910891,1,0
664944,Cam Vieaux,2022,AAA,20,13,21,33,3,1,4,0.1212121212121212,0.75,0.0909090909090909,1,0
664948,Anthony Misiewicz,2022,AAA,8,4,6,12,0,0,0,0.0,,0.0,1,0
665001,Trevor Kelley,2022,AAA,16,9,16,25,1,0,1,0.04,1.0,0.04,1,0
665048,Hobie Harris,2022,AAA,28,19,27,47,4,1,5,0.1063829787234042,0.8,0.0851063829787234,1,0
665135,Shea Murray,2022,AAA,8,7,5,15,1,0,1,0.0666666666666666,1.0,0.0666666666666666,1,0
665417,Kyle Kubat,2022,AAA,72,21,30,93,0,1,1,0.010752688172043,0.0,0.0,1,0
665600,Jasseel De La Cruz,2022,AAA,8,11,6,19,1,0,1,0.0526315789473684,1.0,0.0526315789473684,1,0
665620,Deivi García,2022,AAA,31,20,12,51,4,1,5,0.0980392156862745,0.8,0.0784313725490196,1,0
665625,Elvis Peguero,2022,AAA,28,11,21,39,4,0,4,0.1025641025641025,1.0,0.1025641025641025,1,0
665645,Kervin Castro,2022,AAA,32,18,25,50,5,4,9,0.18,0.5555555555555556,0.1,1,0
665661,Shea Spitzbarth,2022,AAA,28,11,22,39,3,1,4,0.1025641025641025,0.75,0.0769230769230769,1,0
665665,Reiver Sanmartin,2022,AAA,16,7,5,23,2,0,2,0.0869565217391304,1.0,0.0869565217391304,1,0
665733,Antonio Santos,2022,AAA,12,6,6,18,0,0,0,0.0,,0.0,1,0
665734,Angel Felipe,2022,AAA,10,3,8,13,1,0,1,0.0769230769230769,1.0,0.0769230769230769,1,0
665751,Yadier Álvarez,2022,AAA,22,26,18,48,4,0,4,0.0833333333333333,1.0,0.0833333333333333,1,0
665795,Edward Cabrera,2022,AAA,15,6,6,21,6,1,7,0.3333333333333333,0.8571428571428571,0.2857142857142857,1,0
665871,Javier Assad,2022,AAA,17,10,6,27,2,0,2,0.074074074074074,1.0,0.074074074074074,1,0
665896,José Marte,2022,AAA,22,15,22,37,5,0,5,0.1351351351351351,1.0,0.1351351351351351,1,0
666005,Andres Sotillet,2022,AAA,19,12,18,31,3,0,3,0.0967741935483871,1.0,0.0967741935483871,1,0
666007,Deyni Olivero,2022,AAA,12,9,5,21,1,2,3,0.1428571428571428,0.3333333333333333,0.0476190476190476,1,0
666120,Ian Anderson,2022,AAA,15,12,4,27,8,0,8,0.2962962962962963,1.0,0.2962962962962963,1,0
666123,Austin Bergner,2022,AAA,22,12,8,34,3,3,6,0.1764705882352941,0.5,0.088235294117647,1,0
666129,Braxton Garrett,2022,AAA,14,10,6,24,4,0,4,0.1666666666666666,1.0,0.1666666666666666,1,0
666130,Jay Groome,2022,AAA,40,21,13,61,2,0,2,0.0327868852459016,1.0,0.0327868852459016,1,0
666142,Cole Ragans,2022,AAA,21,8,8,29,2,0,2,0.0689655172413793,1.0,0.0689655172413793,1,0
666154,Karl Kauffmann,2022,AAA,52,22,13,74,11,1,12,0.1621621621621621,0.9166666666666666,0.1486486486486486,1,0
666159,Matt Manning,2022,AAA,17,5,6,22,4,1,5,0.2272727272727272,0.8,0.1818181818181818,1,0
666168,Mason Thompson,2022,AAA,12,2,8,14,3,1,4,0.2857142857142857,0.75,0.2142857142857142,1,0
666205,Kyle Muller,2022,AAA,82,35,23,117,21,10,31,0.2649572649572649,0.6774193548387096,0.1794871794871795,1,0
666214,Joey Wentz,2022,AAA,29,10,12,39,4,2,6,0.1538461538461538,0.6666666666666666,0.1025641025641025,1,0
666215,Forrest Whitley,2022,AAA,19,18,10,37,1,0,1,0.027027027027027,1.0,0.027027027027027,1,0
666277,George Soriano,2022,AAA,29,10,17,39,1,1,2,0.0512820512820512,0.5,0.0256410256410256,1,0
666364,Jordan Balazovic,2022,AAA,47,35,22,82,1,2,3,0.0365853658536585,0.3333333333333333,0.0121951219512195,1,0
666374,Matt Brash,2022,AAA,15,6,13,21,2,1,3,0.1428571428571428,0.6666666666666666,0.0952380952380952,1,0
666502,Marcelo Martinez,2022,AAA,46,34,23,80,3,0,3,0.0375,1.0,0.0375,1,0
666563,Jeff Singer,2022,AAA,26,9,18,35,0,1,1,0.0285714285714285,0.0,0.0,1,0
666619,Gregory Santos,2022,AAA,23,9,19,32,4,0,4,0.125,1.0,0.125,1,0
666672,Jojanse Torres,2022,AAA,8,7,6,15,0,1,1,0.0666666666666666,0.0,0.0,1,0
666711,Joel Peguero,2022,AAA,54,20,34,74,6,2,8,0.1081081081081081,0.75,0.081081081081081,1,0
666720,Yerry Rodríguez,2022,AAA,36,17,32,53,1,2,3,0.0566037735849056,0.3333333333333333,0.0188679245283018,1,0
666721,Max Castillo,2022,AAA,31,11,12,42,7,1,8,0.1904761904761904,0.875,0.1666666666666666,1,0
666745,Jhony Brito,2022,AAA,44,24,15,68,10,1,11,0.1617647058823529,0.9090909090909092,0.1470588235294117,1,0
666818,Luis Frías,2022,AAA,26,14,17,40,4,1,5,0.125,0.8,0.1,1,0
666974,Yennier Cano,2022,AAA,23,9,22,32,6,0,6,0.1875,1.0,0.1875,1,0
667050,Grant Gavin,2022,AAA,28,10,24,38,2,0,2,0.0526315789473684,1.0,0.0526315789473684,1,0
667176,Grant Black,2022,AAA,27,15,18,42,3,1,4,0.0952380952380952,0.75,0.0714285714285714,1,0
667280,Andrew Misiaszek,2022,AAA,21,13,13,34,0,2,2,0.0588235294117647,0.0,0.0,1,0
667356,Bryan Mata,2022,AAA,21,10,5,31,4,0,4,0.1290322580645161,1.0,0.1290322580645161,1,0
667373,Angel Rondón,2022,AAA,32,15,17,47,7,1,8,0.1702127659574468,0.875,0.1489361702127659,1,0
667376,Miguel Sánchez,2022,AAA,12,6,9,18,0,1,1,0.0555555555555555,0.0,0.0,1,0
667421,Blaine Knight,2022,AAA,62,29,26,91,2,1,3,0.0329670329670329,0.6666666666666666,0.0219780219780219,1,0
667445,Marshall Kasowski,2022,AAA,35,19,26,54,11,1,12,0.2222222222222222,0.9166666666666666,0.2037037037037037,1,0
667463,John King,2022,AAA,12,4,9,16,1,0,1,0.0625,1.0,0.0625,1,0
667465,Aaron Fletcher,2022,AAA,26,15,20,41,5,0,5,0.1219512195121951,1.0,0.1219512195121951,1,0
667498,Robert Dugger,2022,AAA,39,23,18,62,5,0,5,0.0806451612903225,1.0,0.0806451612903225,1,0
667677,Zac Houston,2022,AAA,15,6,12,21,3,1,4,0.1904761904761904,0.75,0.1428571428571428,1,0
667700,Joe Navilhon,2022,AAA,6,5,4,11,0,0,0,0.0,,0.0,1,0
667722,J.B. Olson,2022,AAA,39,28,34,67,8,1,9,0.1343283582089552,0.8888888888888888,0.1194029850746268,1,0
667725,Kyle Tyler,2022,AAA,15,5,11,20,1,0,1,0.05,1.0,0.05,1,0
668338,Tyson Miller,2022,AAA,55,27,27,82,9,5,14,0.1707317073170731,0.6428571428571429,0.1097560975609756,1,0
668390,Cole Winn,2022,AAA,87,46,28,133,11,1,12,0.0902255639097744,0.9166666666666666,0.0827067669172932,1,0
668665,Stephen Nogosek,2022,AAA,28,8,19,36,1,0,1,0.0277777777777777,1.0,0.0277777777777777,1,0
668674,Lucas Erceg,2022,AAA,38,10,24,48,6,0,6,0.125,1.0,0.125,1,0
668683,Jeremy Walker,2022,AAA,37,21,31,58,11,1,12,0.2068965517241379,0.9166666666666666,0.1896551724137931,1,0
668684,Tanner Tully,2022,AAA,92,41,24,133,4,0,4,0.0300751879699248,1.0,0.0300751879699248,1,0
668754,Braden Bristo,2022,AAA,41,19,34,60,17,1,18,0.3,0.9444444444444444,0.2833333333333333,1,0
668757,Matt Dennis,2022,AAA,63,39,30,102,9,1,10,0.0980392156862745,0.9,0.088235294117647,1,0
668766,Dylan File,2022,AAA,61,35,23,96,1,0,1,0.0104166666666666,1.0,0.0104166666666666,1,0
668834,Easton McGee,2022,AAA,56,32,25,88,13,0,13,0.1477272727272727,1.0,0.1477272727272727,1,0
668868,Zack Thompson,2022,AAA,36,14,15,50,4,0,4,0.08,1.0,0.08,1,0
668873,Caleb Kilian,2022,AAA,73,46,26,119,26,4,30,0.2521008403361344,0.8666666666666667,0.2184873949579832,1,0
668933,Graham Ashcraft,2022,AAA,34,15,8,49,1,1,2,0.0408163265306122,0.5,0.0204081632653061,1,0
668948,Kirk McCarty,2022,AAA,34,12,17,46,2,0,2,0.0434782608695652,1.0,0.0434782608695652,1,0
668954,Curtis Taylor,2022,AAA,14,9,15,23,4,0,4,0.1739130434782608,1.0,0.1739130434782608,1,0
668964,Tobias Myers,2022,AAA,56,32,22,88,10,2,12,0.1363636363636363,0.8333333333333334,0.1136363636363636,1,0
668968,Hans Crouse,2022,AAA,10,8,4,18,6,1,7,0.3888888888888889,0.8571428571428571,0.3333333333333333,1,0
669018,Patrick Ruotolo,2022,AAA,15,15,16,30,8,1,9,0.3,0.8888888888888888,0.2666666666666666,1,0
669022,MacKenzie Gore,2022,AAA,7,4,5,11,2,0,2,0.1818181818181818,1.0,0.1818181818181818,1,0
669060,Bryse Wilson,2022,AAA,14,7,6,21,4,0,4,0.1904761904761904,1.0,0.1904761904761904,1,0
669062,Erik Miller,2022,AAA,7,6,7,13,3,0,3,0.2307692307692307,1.0,0.2307692307692307,1,0
669084,DL Hall,2022,AAA,45,27,19,72,11,1,12,0.1666666666666666,0.9166666666666666,0.1527777777777778,1,0
669091,Matt Cronin,2022,AAA,20,11,15,31,1,0,1,0.032258064516129,1.0,0.032258064516129,1,0
669105,Zach Muckenhirn,2022,AAA,34,11,24,45,1,0,1,0.0222222222222222,1.0,0.0222222222222222,1,0
669114,Jace Vines,2022,AAA,9,6,8,15,0,0,0,0.0,,0.0,1,0
669145,Bruce Zimmermann,2022,AAA,49,24,14,73,7,1,8,0.1095890410958904,0.875,0.0958904109589041,1,0
669169,Jonathan Heasley,2022,AAA,20,6,9,26,0,0,0,0.0,,0.0,1,0
669180,Braeden Ogle,2022,AAA,29,21,24,50,5,0,5,0.1,1.0,0.1,1,0
669194,Ryne Nelson,2022,AAA,65,41,26,106,12,1,13,0.1226415094339622,0.9230769230769232,0.1132075471698113,1,0
669205,Lincoln Henzman,2022,AAA,58,26,29,84,3,0,3,0.0357142857142857,1.0,0.0357142857142857,1,0
669214,Conner Menez,2022,AAA,10,6,6,16,5,0,5,0.3125,1.0,0.3125,1,0
669283,Drew Parrish,2022,AAA,60,17,16,77,3,2,5,0.0649350649350649,0.6,0.0389610389610389,1,0
669294,Paul Campbell,2022,AAA,8,2,2,10,1,0,1,0.1,1.0,0.1,1,0
669345,Brett Conine,2022,AAA,90,47,28,137,5,1,6,0.0437956204379562,0.8333333333333334,0.0364963503649635,1,0
669424,Jimmy Lambert,2022,AAA,7,5,3,12,2,1,3,0.25,0.6666666666666666,0.1666666666666666,1,0
669461,Matthew Liberatore,2022,AAA,68,35,22,103,17,1,18,0.174757281553398,0.9444444444444444,0.1650485436893204,1,0
669468,Aaron Leasher,2022,AAA,66,24,28,90,2,2,4,0.0444444444444444,0.5,0.0222222222222222,1,0
669674,Sam Long,2022,AAA,11,5,6,16,1,0,1,0.0625,1.0,0.0625,1,0
669682,Morgan McSweeney,2022,AAA,11,11,13,22,2,3,5,0.2272727272727272,0.4,0.0909090909090909,1,0
669684,Chris Murphy,2022,AAA,53,30,15,83,5,2,7,0.0843373493975903,0.7142857142857143,0.0602409638554216,1,0
669711,Greg Weissert,2022,AAA,27,13,21,40,4,2,6,0.15,0.6666666666666666,0.1,1,0
669713,Hayden Wesneski,2022,AAA,62,28,23,90,7,0,7,0.0777777777777777,1.0,0.0777777777777777,1,0
669721,Davis Daniel,2022,AAA,48,24,20,72,8,3,11,0.1527777777777778,0.7272727272727273,0.1111111111111111,1,0
669725,Thomas Jankins,2022,AAA,17,8,9,25,0,1,1,0.04,0.0,0.0,1,0
669728,Dakota Mekkes,2022,AAA,33,18,20,51,2,0,2,0.0392156862745098,1.0,0.0392156862745098,1,0
669740,Travis MacGregor,2022,AAA,31,17,18,48,1,0,1,0.0208333333333333,1.0,0.0208333333333333,1,0
669746,Tommy Eveld,2022,AAA,17,10,15,27,1,1,2,0.074074074074074,0.5,0.037037037037037,1,0
669804,Angel De Jesus,2022,AAA,21,14,21,35,6,0,6,0.1714285714285714,1.0,0.1714285714285714,1,0
669854,Ronel Blanco,2022,AAA,18,18,24,36,4,0,4,0.1111111111111111,1.0,0.1111111111111111,1,0
669912,Kirby Snead,2022,AAA,9,3,8,12,0,0,0,0.0,,0.0,1,0
669920,Jason Alexander,2022,AAA,45,17,13,62,4,1,5,0.0806451612903225,0.8,0.064516129032258,1,0
669935,A.J. Alexy,2022,AAA,76,27,28,103,14,1,15,0.145631067961165,0.9333333333333332,0.1359223300970873,1,0
669942,Chad Donato,2022,AAA,73,30,25,103,9,4,13,0.1262135922330097,0.6923076923076923,0.087378640776699,1,0
669947,Jesse Scholtens,2022,AAA,40,19,25,59,6,0,6,0.1016949152542373,1.0,0.1016949152542373,1,0
669952,Mitch White,2022,AAA,10,5,3,15,2,0,2,0.1333333333333333,1.0,0.1333333333333333,1,0
670046,Kenny Rosenberg,2022,AAA,30,13,13,43,5,4,9,0.2093023255813953,0.5555555555555556,0.1162790697674418,1,0
670056,Caleb Baragar,2022,AAA,27,15,26,42,3,2,5,0.119047619047619,0.6,0.0714285714285714,1,0
670057,Ryan Hartman,2022,AAA,6,4,3,10,0,0,0,0.0,,0.0,1,0
670059,Colin Holderman,2022,AAA,11,5,10,16,2,0,2,0.125,1.0,0.125,1,0
670065,Trevor Lane,2022,AAA,16,12,18,28,5,1,6,0.2142857142857142,0.8333333333333334,0.1785714285714285,1,0
670078,Ben Krauth,2022,AAA,10,4,9,14,1,1,2,0.1428571428571428,0.5,0.0714285714285714,1,0
670087,Brandyn Sittinger,2022,AAA,18,13,15,31,5,0,5,0.1612903225806451,1.0,0.1612903225806451,1,0
670090,Wyatt Mills,2022,AAA,15,8,15,23,3,0,3,0.1304347826086956,1.0,0.1304347826086956,1,0
670102,Bowden Francis,2022,AAA,54,39,30,93,15,1,16,0.1720430107526881,0.9375,0.1612903225806451,1,0
670104,Colin McKee,2022,AAA,9,8,9,17,0,0,0,0.0,,0.0,1,0
670109,Jacob Bosiokovic,2022,AAA,6,4,6,10,1,0,1,0.1,1.0,0.1,1,0
670119,Connor Grey,2022,AAA,68,51,26,119,8,1,9,0.0756302521008403,0.8888888888888888,0.0672268907563025,1,0
670124,Adam Oller,2022,AAA,24,10,7,34,4,1,5,0.1470588235294117,0.8,0.1176470588235294,1,0
670125,Jonathan Hennigan,2022,AAA,38,14,30,52,1,1,2,0.0384615384615384,0.5,0.0192307692307692,1,0
670151,Wyatt Short,2022,AAA,43,22,21,65,3,0,3,0.0461538461538461,1.0,0.0461538461538461,1,0
670154,Nolan Blackwood,2022,AAA,32,20,27,52,4,2,6,0.1153846153846153,0.6666666666666666,0.0769230769230769,1,0
670161,Parker Dunshee,2022,AAA,74,45,28,119,6,2,8,0.0672268907563025,0.75,0.0504201680672268,1,0
670174,Josh Winckowski,2022,AAA,32,19,12,51,7,0,7,0.1372549019607843,1.0,0.1372549019607843,1,0
670183,Garrett Acton,2022,AAA,28,10,22,38,4,0,4,0.1052631578947368,1.0,0.1052631578947368,1,0
670241,Darius Vines,2022,AAA,22,9,7,31,7,0,7,0.2258064516129032,1.0,0.2258064516129032,1,0
670245,Ryan Watson,2022,AAA,11,3,6,14,0,0,0,0.0,,0.0,1,0
670288,Jake Fishman,2022,AAA,36,16,23,52,4,0,4,0.0769230769230769,1.0,0.0769230769230769,1,0
670329,Rico Garcia,2022,AAA,21,6,15,27,3,1,4,0.1481481481481481,0.75,0.1111111111111111,1,0
670377,Evan Miller,2022,AAA,28,23,30,51,4,0,4,0.0784313725490196,1.0,0.0784313725490196,1,0
670416,Zach Matson,2022,AAA,31,16,21,47,1,0,1,0.0212765957446808,1.0,0.0212765957446808,1,0
670426,Phillip Diehl,2022,AAA,16,19,21,35,3,0,3,0.0857142857142857,1.0,0.0857142857142857,1,0
670436,Mike Ellenbest,2022,AAA,14,11,11,25,1,1,2,0.08,0.5,0.04,1,0
670456,JD Hammer,2022,AAA,37,22,31,59,6,1,7,0.1186440677966101,0.8571428571428571,0.1016949152542373,1,0
670550,Nivaldo Rodriguez,2022,AAA,61,29,17,90,8,0,8,0.0888888888888888,1.0,0.0888888888888888,1,0
670625,Steven Moyers,2022,AAA,22,13,12,35,5,1,6,0.1714285714285714,0.8333333333333334,0.1428571428571428,1,0
670766,Darren McCaughan,2022,AAA,73,37,26,110,6,2,8,0.0727272727272727,0.75,0.0545454545454545,1,0
670810,Logan Gillaspie,2022,AAA,19,9,14,28,1,0,1,0.0357142857142857,1.0,0.0357142857142857,1,0
670912,Johan Oviedo,2022,AAA,38,19,14,57,8,1,9,0.1578947368421052,0.8888888888888888,0.1403508771929824,1,0
670955,Edwin Uceta,2022,AAA,24,10,20,34,4,1,5,0.1470588235294117,0.8,0.1176470588235294,1,0
670990,Yohan Ramírez,2022,AAA,12,6,12,18,2,0,2,0.1111111111111111,1.0,0.1111111111111111,1,0
671106,Logan Allen,2022,AAA,44,21,14,65,6,2,8,0.123076923076923,0.75,0.0923076923076923,1,0
671162,Connor Thomas,2022,AAA,96,56,28,152,9,4,13,0.0855263157894736,0.6923076923076923,0.0592105263157894,1,0
671305,Michel Otañez,2022,AAA,29,17,21,46,4,1,5,0.108695652173913,0.8,0.0869565217391304,1,0
671737,Taj Bradley,2022,AAA,30,13,12,43,2,0,2,0.0465116279069767,1.0,0.0465116279069767,1,0
671790,Ronald Bolaños,2022,AAA,47,22,25,69,2,2,4,0.0579710144927536,0.5,0.0289855072463768,1,0
672391,Kaleb Ort,2022,AAA,24,11,21,35,2,1,3,0.0857142857142857,0.6666666666666666,0.0571428571428571,1,0
672550,Danis Correa,2022,AAA,14,9,10,23,5,1,6,0.2608695652173913,0.8333333333333334,0.217391304347826,1,0
672578,Carlos Hernández,2022,AAA,25,9,10,34,3,1,4,0.1176470588235294,0.75,0.088235294117647,1,0
672710,Roansy Contreras,2022,AAA,16,8,7,24,5,0,5,0.2083333333333333,1.0,0.2083333333333333,1,0
672715,Luis Patiño,2022,AAA,24,9,8,33,4,2,6,0.1818181818181818,0.6666666666666666,0.1212121212121212,1,0
672839,Francisco Morales,2022,AAA,19,13,18,32,7,0,7,0.21875,1.0,0.21875,1,0
672841,Carlos Vargas,2022,AAA,8,2,6,10,1,0,1,0.1,1.0,0.1,1,0
672848,Noe Toribio,2022,AAA,35,27,19,62,8,1,9,0.1451612903225806,0.8888888888888888,0.1290322580645161,1,0
672851,Joan Adon,2022,AAA,31,17,10,48,3,0,3,0.0625,1.0,0.0625,1,0
672911,Jesus Cruz,2022,AAA,15,8,15,23,6,0,6,0.2608695652173913,1.0,0.2608695652173913,1,0
673257,Victor Santos,2022,AAA,25,14,9,39,0,0,0,0.0,,0.0,1,0
673258,Michel Baez,2022,AAA,18,13,13,31,1,0,1,0.032258064516129,1.0,0.032258064516129,1,0
673316,Luke Barker,2022,AAA,8,7,7,15,0,0,0,0.0,,0.0,1,0
673603,Luis Romero,2022,AAA,41,21,30,62,5,0,5,0.0806451612903225,1.0,0.0806451612903225,1,0
673904,Jake Walsh,2022,AAA,8,7,8,15,4,0,4,0.2666666666666666,1.0,0.2666666666666666,1,0
674072,Tommy Henry,2022,AAA,63,35,21,98,17,5,22,0.2244897959183673,0.7727272727272727,0.173469387755102,1,0
674342,Jakob Hernandez,2022,AAA,23,19,27,42,3,2,5,0.119047619047619,0.6,0.0714285714285714,1,0
674370,Osvaldo Bido,2022,AAA,77,43,30,120,17,5,22,0.1833333333333333,0.7727272727272727,0.1416666666666666,1,0
674681,Michael Plassmeyer,2022,AAA,68,33,26,101,3,8,11,0.1089108910891089,0.2727272727272727,0.0297029702970297,1,0
674810,Victor Castaneda,2022,AAA,9,4,3,13,1,0,1,0.0769230769230769,1.0,0.0769230769230769,1,0
675195,Juan Mercedes,2022,AAA,11,5,3,16,2,0,2,0.125,1.0,0.125,1,0
675540,Xzavion Curry,2022,AAA,32,13,11,45,5,2,7,0.1555555555555555,0.7142857142857143,0.1111111111111111,1,0
675627,Michael Grove,2022,AAA,27,20,12,47,6,0,6,0.1276595744680851,1.0,0.1276595744680851,1,0
675912,Zac Lowther,2022,AAA,34,30,15,64,4,2,6,0.09375,0.6666666666666666,0.0625,1,0
675916,James Karinchak,2022,AAA,7,8,7,15,3,0,3,0.2,1.0,0.2,1,0
675921,Spencer Howard,2022,AAA,27,16,14,43,4,2,6,0.1395348837209302,0.6666666666666666,0.0930232558139534,1,0
675923,Ryan Lillie,2022,AAA,10,4,5,14,2,0,2,0.1428571428571428,1.0,0.1428571428571428,1,0
675971,Kyle Dohy,2022,AAA,12,10,10,22,5,0,5,0.2272727272727272,1.0,0.2272727272727272,1,0
675976,Mark Washington,2022,AAA,26,14,20,40,3,1,4,0.1,0.75,0.075,1,0
675977,Drew Strotman,2022,AAA,39,24,29,63,2,0,2,0.0317460317460317,1.0,0.0317460317460317,1,0
675989,Cody Bolton,2022,AAA,43,25,27,68,7,1,8,0.1176470588235294,0.875,0.1029411764705882,1,0
676050,Packy Naughton,2022,AAA,9,5,8,14,0,0,0,0.0,,0.0,1,0
676083,Janson Junk,2022,AAA,34,21,15,55,10,0,10,0.1818181818181818,1.0,0.1818181818181818,1,0
676092,Collin Snider,2022,AAA,17,10,13,27,1,0,1,0.037037037037037,1.0,0.037037037037037,1,0
676111,Shawn Semple,2022,AAA,17,8,4,25,1,0,1,0.04,1.0,0.04,1,0
676130,José Buttó,2022,AAA,14,6,6,20,4,0,4,0.2,1.0,0.2,1,0
676194,Jackson Tetreault,2022,AAA,32,10,12,42,1,0,1,0.0238095238095238,1.0,0.0238095238095238,1,0
676206,Freddy Tarnok,2022,AAA,19,8,10,27,1,1,2,0.074074074074074,0.5,0.037037037037037,1,0
676220,Seth Elledge,2022,AAA,16,15,21,31,8,1,9,0.2903225806451613,0.8888888888888888,0.2580645161290322,1,0
676252,Zach Haake,2022,AAA,6,5,4,11,0,1,1,0.0909090909090909,0.0,0.0,1,0
676254,Ryan Walker,2022,AAA,7,5,4,12,0,0,0,0.0,,0.0,1,0
676265,Cory Abbott,2022,AAA,22,12,12,34,9,1,10,0.2941176470588235,0.9,0.2647058823529412,1,0
676272,Bobby Miller,2022,AAA,11,3,4,14,2,0,2,0.1428571428571428,1.0,0.1428571428571428,1,0
676292,Hunter Breault,2022,AAA,6,4,4,10,0,0,0,0.0,,0.0,1,0
676395,Robert Garcia,2022,AAA,39,16,26,55,6,0,6,0.109090909090909,1.0,0.109090909090909,1,0
676424,Alec Bettinger,2022,AAA,27,15,12,42,3,2,5,0.119047619047619,0.6,0.0714285714285714,1,0
676515,Cam Robinson,2022,AAA,12,6,9,18,0,1,1,0.0555555555555555,0.0,0.0,1,0
676534,Calvin Faucher,2022,AAA,29,15,25,44,11,0,11,0.25,1.0,0.25,1,0
676546,Michael Gomez,2022,AAA,46,34,35,80,8,0,8,0.1,1.0,0.1,1,0
676571,PJ Poulin,2022,AAA,17,8,14,25,1,0,1,0.04,1.0,0.04,1,0
676596,Josh Fleming,2022,AAA,50,19,15,69,4,1,5,0.072463768115942,0.8,0.0579710144927536,1,0
676599,Jason Bahr,2022,AAA,21,17,14,38,4,1,5,0.131578947368421,0.8,0.1052631578947368,1,0
676606,Nick Margevicius,2022,AAA,47,27,25,74,7,1,8,0.1081081081081081,0.875,0.0945945945945946,1,0
676607,Hunter Schryver,2022,AAA,29,15,21,44,6,1,7,0.1590909090909091,0.8571428571428571,0.1363636363636363,1,0
676617,Riley O'Brien,2022,AAA,38,18,23,56,7,2,9,0.1607142857142857,0.7777777777777778,0.125,1,0
676620,Blake Weiman,2022,AAA,12,5,9,17,2,0,2,0.1176470588235294,1.0,0.1176470588235294,1,0
676637,Phoenix Sanders,2022,AAA,15,11,16,26,0,1,1,0.0384615384615384,0.0,0.0,1,0
676641,Beau Sulser,2022,AAA,38,19,18,57,0,0,0,0.0,,0.0,1,0
676660,Jared Solomon,2022,AAA,36,20,24,56,3,1,4,0.0714285714285714,0.75,0.0535714285714285,1,0
676664,JP Sears,2022,AAA,17,10,11,27,6,1,7,0.2592592592592592,0.8571428571428571,0.2222222222222222,1,0
676680,Tom Cosgrove,2022,AAA,16,11,15,27,3,0,3,0.1111111111111111,1.0,0.1111111111111111,1,0
676689,Ricky Karcher,2022,AAA,22,10,18,32,5,2,7,0.21875,0.7142857142857143,0.15625,1,0
676702,Hunter Stratton,2022,AAA,41,22,29,63,6,0,6,0.0952380952380952,1.0,0.0952380952380952,1,0
676710,Kutter Crawford,2022,AAA,17,8,5,25,1,0,1,0.04,1.0,0.04,1,0
676720,Tommy Romero,2022,AAA,44,14,21,58,6,2,8,0.1379310344827586,0.75,0.1034482758620689,1,0
676726,Chris Muller,2022,AAA,46,20,30,66,9,0,9,0.1363636363636363,1.0,0.1363636363636363,1,0
676742,Cam Sanders,2022,AAA,47,28,20,75,4,0,4,0.0533333333333333,1.0,0.0533333333333333,1,0
676755,Isaac Mattson,2022,AAA,16,8,13,24,0,1,1,0.0416666666666666,0.0,0.0,1,0
676766,Nick Snyder,2022,AAA,23,16,20,39,7,0,7,0.1794871794871795,1.0,0.1794871794871795,1,0
676831,Kodi Whitley,2022,AAA,17,8,16,25,4,0,4,0.16,1.0,0.16,1,0
676840,Matt Peacock,2022,AAA,20,14,17,34,0,0,0,0.0,,0.0,1,0
676886,Jeremy Beasley,2022,AAA,18,4,13,22,1,1,2,0.0909090909090909,0.5,0.0454545454545454,1,0
676898,Zach Draper,2022,AAA,13,5,8,18,3,1,4,0.2222222222222222,0.75,0.1666666666666666,1,0
676917,Cade Cavalli,2022,AAA,55,24,19,79,7,2,9,0.1139240506329113,0.7777777777777778,0.0886075949367088,1,0
676942,Graham Spraker,2022,AAA,20,15,18,35,0,0,0,0.0,,0.0,1,0
676949,Miller Hogan,2022,AAA,12,8,6,20,2,1,3,0.15,0.6666666666666666,0.1,1,0
676961,Caleb Boushley,2022,AAA,66,28,25,94,10,3,13,0.1382978723404255,0.7692307692307693,0.1063829787234042,1,0
676974,Max Meyer,2022,AAA,28,15,10,43,2,0,2,0.0465116279069767,1.0,0.0465116279069767,1,0
676987,Tim Naughton,2022,AAA,11,8,10,19,6,0,6,0.3157894736842105,1.0,0.3157894736842105,1,0
677020,Josh Walker,2022,AAA,10,6,8,16,2,0,2,0.125,1.0,0.125,1,0
677023,Carson Teel,2022,AAA,28,17,17,45,4,1,5,0.1111111111111111,0.8,0.0888888888888888,1,0
677053,Andrew Nardi,2022,AAA,6,5,7,11,0,0,0,0.0,,0.0,1,0
677161,Zack Kelly,2022,AAA,29,19,21,48,5,0,5,0.1041666666666666,1.0,0.1041666666666666,1,0
677185,Matt Hardy,2022,AAA,30,17,23,47,2,2,4,0.0851063829787234,0.5,0.0425531914893617,1,0
677362,Nick Kuzia,2022,AAA,7,7,5,14,0,0,0,0.0,,0.0,1,0
677369,Austin Warner,2022,AAA,63,29,27,92,1,0,1,0.0108695652173913,1.0,0.0108695652173913,1,0
677865,Justin Bruihl,2022,AAA,24,13,20,37,7,1,8,0.2162162162162162,0.875,0.1891891891891892,1,0
677960,Ryan Weathers,2022,AAA,90,45,28,135,6,8,14,0.1037037037037037,0.4285714285714285,0.0444444444444444,1,0
677976,Randy Dobnak,2022,AAA,15,8,6,23,1,0,1,0.0434782608695652,1.0,0.0434782608695652,1,0
678061,Ray Kerr,2022,AAA,37,17,34,54,4,1,5,0.0925925925925925,0.8,0.074074074074074,1,0
678394,Brayan Bello,2022,AAA,33,12,11,45,2,0,2,0.0444444444444444,1.0,0.0444444444444444,1,0
678692,Ronny Henriquez,2022,AAA,58,33,24,91,9,2,11,0.1208791208791208,0.8181818181818182,0.0989010989010989,1,0
679358,Eric Orze,2022,AAA,25,19,23,44,5,1,6,0.1363636363636363,0.8333333333333334,0.1136363636363636,1,0
679777,Nick Mikolajchak,2022,AAA,29,16,26,45,5,2,7,0.1555555555555555,0.7142857142857143,0.1111111111111111,1,0
679928,Evan McKendry,2022,AAA,11,2,3,13,1,0,1,0.0769230769230769,1.0,0.0769230769230769,1,0
680430,Nick Allgeyer,2022,AAA,61,33,31,94,4,1,5,0.0531914893617021,0.8,0.0425531914893617,1,0
680543,Jake Lee,2022,AAA,15,8,8,23,6,1,7,0.3043478260869565,0.8571428571428571,0.2608695652173913,1,0
680570,Grayson Rodriguez,2022,AAA,27,17,13,44,4,1,5,0.1136363636363636,0.8,0.0909090909090909,1,0
680573,Simeon Woods Richardson,2022,AAA,17,3,7,20,7,0,7,0.35,1.0,0.35,1,0
680723,Drew Rom,2022,AAA,24,14,7,38,1,0,1,0.0263157894736842,1.0,0.0263157894736842,1,0
680732,Sean Burke,2022,AAA,8,4,2,12,0,0,0,0.0,,0.0,1,0
680735,Austin Cox,2022,AAA,90,48,28,138,3,0,3,0.0217391304347826,1.0,0.0217391304347826,1,0
680739,Josh Winder,2022,AAA,6,4,5,10,1,0,1,0.1,1.0,0.1,1,0
680767,Victor Vodnik,2022,AAA,22,9,17,31,1,1,2,0.064516129032258,0.5,0.032258064516129,1,0
680802,Ryan Weiss,2022,AAA,34,19,25,53,7,1,8,0.1509433962264151,0.875,0.1320754716981132,1,0
680940,Robert Broom,2022,AAA,10,9,12,19,2,0,2,0.1052631578947368,1.0,0.1052631578947368,1,0
680961,Chris Gau,2022,AAA,10,2,6,12,0,1,1,0.0833333333333333,0.0,0.0,1,0
680970,Andrew Pérez,2022,AAA,39,19,33,58,3,1,4,0.0689655172413793,0.75,0.0517241379310344,1,0
681006,Josh Simpson,2022,AAA,8,4,8,12,6,0,6,0.5,1.0,0.5,1,0
681007,Jack Cushing,2022,AAA,21,6,6,27,2,0,2,0.074074074074074,1.0,0.074074074074074,1,0
681145,Cayne Ueckert,2022,AAA,48,18,29,66,7,1,8,0.1212121212121212,0.875,0.106060606060606,1,0
681259,Aaron Pinto,2022,AAA,28,14,25,42,3,0,3,0.0714285714285714,1.0,0.0714285714285714,1,0
681347,Mike Burrows,2022,AAA,23,11,11,34,0,1,1,0.0294117647058823,0.0,0.0,1,0
681401,Josh Green,2022,AAA,14,8,7,22,0,1,1,0.0454545454545454,0.0,0.0,1,0
681407,Blake Whitney,2022,AAA,20,8,11,28,2,0,2,0.0714285714285714,1.0,0.0714285714285714,1,0
681464,Frank German,2022,AAA,22,7,19,29,4,2,6,0.2068965517241379,0.6666666666666666,0.1379310344827586,1,0
681493,Eddy Demurias,2022,AAA,37,25,34,62,5,0,5,0.0806451612903225,1.0,0.0806451612903225,1,0
681555,Andrew Politi,2022,AAA,26,18,20,44,4,0,4,0.0909090909090909,1.0,0.0909090909090909,1,0
681643,Freddy Pacheco,2022,AAA,19,10,13,29,4,0,4,0.1379310344827586,1.0,0.1379310344827586,1,0
681753,Adrian Hernandez,2022,AAA,16,11,14,27,7,1,8,0.2962962962962963,0.875,0.2592592592592592,1,0
681792,Adam Scott,2022,AAA,52,31,29,83,5,1,6,0.072289156626506,0.8333333333333334,0.0602409638554216,1,0
681795,Ryan Conroy,2022,AAA,30,17,19,47,8,1,9,0.1914893617021276,0.8888888888888888,0.1702127659574468,1,0
681808,Chris Vallimont,2022,AAA,41,29,15,70,8,0,8,0.1142857142857142,1.0,0.1142857142857142,1,0
681810,Austin Warren,2022,AAA,22,11,18,33,3,1,4,0.1212121212121212,0.75,0.0909090909090909,1,0
681835,Jose Quezada,2022,AAA,15,13,12,28,0,0,0,0.0,,0.0,1,0
681856,Thomas Ponticelli,2022,AAA,14,6,12,20,4,0,4,0.2,1.0,0.2,1,0
681867,Cooper Criswell,2022,AAA,20,8,10,28,1,1,2,0.0714285714285714,0.5,0.0357142857142857,1,0
681869,Shawn Dubin,2022,AAA,41,14,21,55,4,0,4,0.0727272727272727,1.0,0.0727272727272727,1,0
681871,Eli Villalobos,2022,AAA,12,6,9,18,3,0,3,0.1666666666666666,1.0,0.1666666666666666,1,0
681891,Zach Greene,2022,AAA,40,16,29,56,5,2,7,0.125,0.7142857142857143,0.0892857142857142,1,0
681895,Evan Sisk,2022,AAA,24,11,20,35,6,0,6,0.1714285714285714,1.0,0.1714285714285714,1,0
681902,Brad Case,2022,AAA,8,7,4,15,0,0,0,0.0,,0.0,1,0
681924,R.J. Dabovich,2022,AAA,14,10,14,24,5,2,7,0.2916666666666667,0.7142857142857143,0.2083333333333333,1,0
681958,Devin Conn,2022,AAA,12,7,9,19,0,0,0,0.0,,0.0,1,0
681982,Grant Anderson,2022,AAA,10,3,7,13,1,0,1,0.0769230769230769,1.0,0.0769230769230769,1,0
682002,Blake Workman,2022,AAA,20,16,17,36,3,2,5,0.1388888888888889,0.6,0.0833333333333333,1,0
682010,Lane Ramsey,2022,AAA,12,9,14,21,5,0,5,0.238095238095238,1.0,0.238095238095238,1,0
682016,William Woods,2022,AAA,11,11,11,22,2,1,3,0.1363636363636363,0.6666666666666666,0.0909090909090909,1,0
682023,Josh Dye,2022,AAA,37,19,29,56,2,1,3,0.0535714285714285,0.6666666666666666,0.0357142857142857,1,0
682027,Cam Alldred,2022,AAA,41,23,32,64,2,1,3,0.046875,0.6666666666666666,0.03125,1,0
682044,Sean Boyle,2022,AAA,31,9,9,40,2,4,6,0.15,0.3333333333333333,0.05,1,0
682051,Garrett Hill,2022,AAA,26,10,8,36,2,0,2,0.0555555555555555,1.0,0.0555555555555555,1,0
682120,Tim Herrin,2022,AAA,26,19,23,45,1,1,2,0.0444444444444444,0.5,0.0222222222222222,1,0
682175,Joe Jacques,2022,AAA,23,14,19,37,2,1,3,0.081081081081081,0.6666666666666666,0.054054054054054,1,0
682227,Brandon Williamson,2022,AAA,40,12,13,52,5,0,5,0.0961538461538461,1.0,0.0961538461538461,1,0
682418,Tommy Parsons,2022,AAA,53,30,28,83,5,0,5,0.0602409638554216,1.0,0.0602409638554216,1,0
682448,Jackson Rees,2022,AAA,8,5,6,13,0,0,0,0.0,,0.0,1,0
682489,Joe Record,2022,AAA,25,21,24,46,9,0,9,0.1956521739130435,1.0,0.1956521739130435,1,0
682615,John O'Reilly,2022,AAA,51,30,30,81,0,0,0,0.0,,0.0,1,0
683232,Nick Mears,2022,AAA,13,10,12,23,8,2,10,0.4347826086956521,0.8,0.3478260869565217,1,0
683769,Hunter Gaddis,2022,AAA,17,9,9,26,0,1,1,0.0384615384615384,0.0,0.0,1,0
684544,Jimmy Endersby,2022,AAA,24,24,12,48,2,1,3,0.0625,0.6666666666666666,0.0416666666666666,1,0
684604,Aaron Ochsenbein,2022,AAA,17,9,10,26,1,0,1,0.0384615384615384,1.0,0.0384615384615384,1,0
685126,Brandon Eisert,2022,AAA,36,18,29,54,6,4,10,0.1851851851851851,0.6,0.1111111111111111,1,0
685410,Peyton Battenfield,2022,AAA,83,41,26,124,11,3,14,0.1129032258064516,0.7857142857142857,0.0887096774193548,1,0
685503,Kohei Arihara,2022,AAA,56,22,19,78,8,0,8,0.1025641025641025,1.0,0.1025641025641025,1,0
686539,Declan Cronin,2022,AAA,13,9,13,22,1,2,3,0.1363636363636363,0.3333333333333333,0.0454545454545454,1,0
686599,Kyle Brnovich,2022,AAA,6,4,2,10,0,0,0,0.0,,0.0,1,0
686610,Ken Waldichuk,2022,AAA,37,17,15,54,7,1,8,0.1481481481481481,0.875,0.1296296296296296,1,0
686613,Hunter Brown,2022,AAA,62,17,22,79,11,1,12,0.1518987341772152,0.9166666666666666,0.1392405063291139,1,0
686651,Levi Stoudt,2022,AAA,10,6,6,16,2,1,3,0.1875,0.6666666666666666,0.125,1,0
686730,Carson Spiers,2022,AAA,14,7,5,21,0,0,0,0.0,,0.0,1,0
686752,Ryan Pepiot,2022,AAA,49,18,18,67,5,1,6,0.0895522388059701,0.8333333333333334,0.0746268656716417,1,0
686753,Drey Jameson,2022,AAA,67,44,22,111,5,3,8,0.072072072072072,0.625,0.045045045045045,1,0
686768,Ryan Smith,2022,AAA,63,24,26,87,1,0,1,0.0114942528735632,1.0,0.0114942528735632,1,0
686856,Cody Mincey,2022,AAA,15,6,4,21,3,0,3,0.1428571428571428,1.0,0.1428571428571428,1,0
686933,Mitchell Stumpo,2022,AAA,29,12,20,41,4,0,4,0.0975609756097561,1.0,0.0975609756097561,1,0
686973,Louis Varland,2022,AAA,8,3,3,11,1,0,1,0.0909090909090909,1.0,0.0909090909090909,1,0
686993,Justin Sterner,2022,AAA,6,6,5,12,0,0,0,0.0,,0.0,1,0
687330,Kevin Kelly,2022,AAA,20,11,17,31,3,0,3,0.0967741935483871,1.0,0.0967741935483871,1,0
687498,Brian Marconi,2022,AAA,13,4,9,17,2,1,3,0.1764705882352941,0.6666666666666666,0.1176470588235294,1,0
687765,Mitch Spence,2022,AAA,34,17,10,51,5,0,5,0.0980392156862745,1.0,0.0980392156862745,1,0
687849,Zak Kent,2022,AAA,11,3,5,14,1,0,1,0.0714285714285714,1.0,0.0714285714285714,1,0
687856,Andrew Bash,2022,AAA,23,9,7,32,0,1,1,0.03125,0.0,0.0,1,0
688010,Nate Fisher,2022,AAA,36,15,16,51,2,1,3,0.0588235294117647,0.6666666666666666,0.0392156862745098,1,0
688107,Robert Gasser,2022,AAA,20,11,5,31,4,1,5,0.1612903225806451,0.8,0.1290322580645161,1,0
688445,Jake Walkinshaw,2022,AAA,9,6,4,15,2,0,2,0.1333333333333333,1.0,0.1333333333333333,1,0
689167,Jeff Lindgren,2022,AAA,44,19,15,63,3,0,3,0.0476190476190476,1.0,0.0476190476190476,1,0
689225,Beau Brieske,2022,AAA,10,1,4,11,0,1,1,0.0909090909090909,0.0,0.0,1,0
689690,Alek Jacob,2022,AAA,11,7,10,18,0,0,0,0.0,,0.0,1,0
690103,Chris Jefferson,2022,AAA,10,6,4,16,0,0,0,0.0,,0.0,1,0
690345,Pedro Garcia,2022,AAA,8,5,7,13,1,0,1,0.0769230769230769,1.0,0.0769230769230769,1,0
690736,Trey McGough,2022,AAA,9,2,5,11,2,1,3,0.2727272727272727,0.6666666666666666,0.1818181818181818,1,0
691068,Michael Stryffeler,2022,AAA,9,6,10,15,0,0,0,0.0,,0.0,1,0
691094,Randy Wynne,2022,AAA,77,33,25,110,6,1,7,0.0636363636363636,0.8571428571428571,0.0545454545454545,1,0
693821,Bryce Elder,2022,AAA,55,27,18,82,10,3,13,0.1585365853658536,0.7692307692307693,0.1219512195121951,1,0
694297,Brandon Pfaadt,2022,AAA,26,11,10,37,5,1,6,0.1621621621621621,0.8333333333333334,0.1351351351351351,1,0
694363,Jared Shuster,2022,AAA,26,11,10,37,5,1,6,0.1621621621621621,0.8333333333333334,0.1351351351351351,1,0
694372,Adam Seminaris,2022,AAA,23,14,9,37,0,1,1,0.027027027027027,0.0,0.0,1,0
694813,Gavin Stone,2022,AAA,7,4,4,11,0,0,0,0.0,,0.0,1,0
695445,Chase Lee,2022,AAA,20,14,18,34,0,0,0,0.0,,0.0,1,0
696522,Hayden Juenger,2022,AAA,12,5,11,17,1,0,1,0.0588235294117647,1.0,0.0588235294117647,1,0
702352,Spencer Bivens,2022,AAA,11,6,6,17,1,0,1,0.0588235294117647,1.0,0.0588235294117647,1,0
702795,Ryan Loutos,2022,AAA,29,16,17,45,5,3,8,0.1777777777777777,0.625,0.1111111111111111,1,0
